Nume	Prenume	Instanta
BĂNCILĂ	ANDREI DORIN	CurteadeApelALBAIULIA
CISMARU 	MONICA MARIA	CurteadeApelALBAIULIA
CLONTA	MARIANA CLAUDIA	CurteadeApelALBAIULIA
COJAN 	MIHAELA FLORENTINA	CurteadeApelALBAIULIA
COJOCARU	CARLA - MARIA	CurteadeApelALBAIULIA
CORAŞ	LEONTIN	CurteadeApelALBAIULIA
COVACIU	MARIA ELENA	CurteadeApelALBAIULIA
DAVID	DIANA BIANCA	CurteadeApelALBAIULIA
DEHELEAN	LAURA-MARIA	CurteadeApelALBAIULIA
DORIANI	ANA	CurteadeApelALBAIULIA
DURBACĂ	NICOLAE	CurteadeApelALBAIULIA
FARCAS	MONICA FELICIA	CurteadeApelALBAIULIA
FIT	CARMEN CORINA	CurteadeApelALBAIULIA
FLOREA	MARIETA CAROLINA	CurteadeApelALBAIULIA
GHERMAN	LUCIAN IOAN	CurteadeApelALBAIULIA
GHITOAICA	ILEANA DANA	CurteadeApelALBAIULIA
HANCĂŞ	EMIL ADRIAN	CurteadeApelALBAIULIA
IONESCU	MARIUS IONEL	CurteadeApelALBAIULIA
IRIMIE	MARIUS CORNEL	CurteadeApelALBAIULIA
KERESZTES	MARIA	CurteadeApelALBAIULIA
LODOABA	ALINA	CurteadeApelALBAIULIA
MARCU	STANCA - IOANA	CurteadeApelALBAIULIA
MARGINEAN	LETITIA DANIELA	CurteadeApelALBAIULIA
MERCA	GABRIELA MIHAELA	CurteadeApelALBAIULIA
MOCAN	AURELIAN GHEORGHE	CurteadeApelALBAIULIA
MAN	MARIOARA CECILIA	CurteadeApelALBAIULIA
MOTOLEA	MARIUS AUREL	CurteadeApelALBAIULIA
NANEA 	MARIANA NICOLETA	CurteadeApelALBAIULIA
NEAMTIU	ANCA ALEXANDRINA	CurteadeApelALBAIULIA
NICOARA	CRISTINA GHEORGHINA	CurteadeApelALBAIULIA
NOŞLĂCAN	MIRCEA	CurteadeApelALBAIULIA
ODAGIU	GHEORGHE - LIVIU	CurteadeApelALBAIULIA
PAŞTIU	ALEXANDRA IULIANA	CurteadeApelALBAIULIA
PETRAŞCU	OANA - MARIA	CurteadeApelALBAIULIA
POP	FLORINA IONELA	CurteadeApelALBAIULIA
POP	MIRELA CĂTĂLINA	CurteadeApelALBAIULIA
PURA	ANCUŢA	CurteadeApelALBAIULIA
STÂNGĂ	OLIMPIA MARIA	CurteadeApelALBAIULIA
STOICA	MANUELA CORINA	CurteadeApelALBAIULIA
ŞERBAN	MĂDĂLINA	CurteadeApelALBAIULIA
TITIAN	DANA	CurteadeApelALBAIULIA
TRIF	SANDA	CurteadeApelALBAIULIA
VESA	NICOLETA MANUELA	CurteadeApelALBAIULIA
ARION	BLANCA ADELA	TribunalulALBA
BISU PREDAN	GEORGETA	TribunalulALBA
BUTA 	BOGDAN MARIUS	TribunalulALBA
CHIRIAC	DRAGOS SEBASTIAN	TribunalulALBA
COSTEA	MONICA CRISTINA	TribunalulALBA
CROITORU	CARMEN	TribunalulALBA
DAMIAN	LIVIA	TribunalulALBA
DUMBRĂVEAN	ELENA	TribunalulALBA
FONOAGE	CAMELIA ILEANA	TribunalulALBA
FULEA	MARIA ELENA AURELIANA	TribunalulALBA
GASPAR	ELENA DANIELA	TribunalulALBA
ILIESCU	GEORGETA	TribunalulALBA
IOSA	SILVIA	TribunalulALBA
LUPE	CARMEN	TribunalulALBA
LUPEAN	HADRIAN	TribunalulALBA
MENCHIU	MARIUS IOAN	TribunalulALBA
MUNTEAN	GIANINA CRISTINELA	TribunalulALBA
MURESAN	CORNELIA	TribunalulALBA
PASCARU PAG	ELENA LUCIA	TribunalulALBA
POLEAC	MIRELA SORINA	TribunalulALBA
POMANĂ	FLORIN	TribunalulALBA
POP	AURELIU CLAUDIU	TribunalulALBA
POPESCU	LAURA AURELIA	TribunalulALBA
SIMA	DIANA MARIA	TribunalulALBA
SIMION	ILEANA GABRIELA	TribunalulALBA
ŞCHIOPU	FLORICA	TribunalulALBA
ŢÂMPEA	TEODORA - MARIA	TribunalulALBA
VALUCH	LUMINITA	TribunalulALBA
BASARABA 	LUCIA	JudecatoriaALBAIULIA
BIC	DENISA MARIA	JudecatoriaALBAIULIA
COTEA	FELICIAN SERGIU	JudecatoriaALBAIULIA
CREŢA	MARIA - OFELIA	JudecatoriaALBAIULIA
CRISTEA	HORIA DORIN	JudecatoriaALBAIULIA
DRAGOŞ	NICOLETA EMILIA	JudecatoriaALBAIULIA
GLIGOR	GABRIELA FLORENTINA	JudecatoriaALBAIULIA
GROZAV	ADRIANA - MARIA	JudecatoriaALBAIULIA
HORVAT	EMILIA LAVINIA	JudecatoriaALBAIULIA
MENCHIU	DENISA FLAVIA	JudecatoriaALBAIULIA
PLEŞA 	DIANA ELISABETH	JudecatoriaALBAIULIA
SALCU - POP	IOANA CRISTINA	JudecatoriaALBAIULIA
SÎRBU	ANA-DANIELA	JudecatoriaALBAIULIA
SÎRBU	FLORIN	JudecatoriaALBAIULIA
TOTH	ŞTEFAN OVIDIU	JudecatoriaALBAIULIA
AXINTE	CONSTANTIN	JudecatoriaCAMPENI
COROIU	VIORICA ELENA	JudecatoriaCAMPENI
COZMA	VIOREL DAN	JudecatoriaCAMPENI
DANCIU	STEFAN CORNEL	JudecatoriaCAMPENI
BIC	ANCA MARIA	JudecatoriaAIUD
CRIŞAN	MARIA LUMINIŢA	JudecatoriaAIUD
FILIMON	ELENA ADRIANA	JudecatoriaAIUD
FILIP	LUMINIŢA MARIA	JudecatoriaAIUD
MITRICĂ	VIORICA	JudecatoriaAIUD
TEODORESCU	ANA FELICIA	JudecatoriaAIUD
BRĂDOSU	ADRIANA – BIANCA	JudecatoriaBLAJ
FOLEA	CAMELIA	JudecatoriaBLAJ
ONIGA	DIANA	JudecatoriaBLAJ
STANCIU	ROXANA ELENA	JudecatoriaBLAJ
MARCU	LIVIU MARCEL	JudecatoriaSEBES
RĂZĂILĂ 	CARMEN SIMONA	JudecatoriaSEBES
RUSU	LAURA	JudecatoriaSEBES
SAVU 	ANA – MARIA	JudecatoriaSEBES
BADISTRU	ELLA CRISTINA	TribunalulHUNEDOARA
BOLOLOI	MIHAELA SIMONA	TribunalulHUNEDOARA
BRICEAG	PERICLE	TribunalulHUNEDOARA
BULIGAN	MIHAELA LILIANA	TribunalulHUNEDOARA
BUZDUGEANU	CRISTINA	TribunalulHUNEDOARA
CĂLĂRAŞU	CRISTINA VIOLETA	TribunalulHUNEDOARA
CONTA	MIHAELA –AURELIA	TribunalulHUNEDOARA
COREGA	ADRIAN DUMITRU	TribunalulHUNEDOARA
COTEA	MARIA	TribunalulHUNEDOARA
DRAGAN	IOAN	TribunalulHUNEDOARA
DRAIA	VIOLINA FLOAREA	TribunalulHUNEDOARA
DUCA	CORINA MARIANA	TribunalulHUNEDOARA
FILIMON	CORNELIA	TribunalulHUNEDOARA
GORON	MARIA	TribunalulHUNEDOARA
GROZAVESCU	ANUTA	TribunalulHUNEDOARA
IACOB	MARINELA	TribunalulHUNEDOARA
IFTIMUS	ADINA-CAMELIA	TribunalulHUNEDOARA
IOJA	IOAN EUGEN	TribunalulHUNEDOARA
MUGESCU	VIORICA ADRIANA	TribunalulHUNEDOARA
ROGOVEANU	ION	TribunalulHUNEDOARA
RONCIOIU	CRISTINA ROBERTA	TribunalulHUNEDOARA
SABAU	DORINA	TribunalulHUNEDOARA
SAVA	IOAN ADRIAN	TribunalulHUNEDOARA
STANCIU	ANCA LUCIA	TribunalulHUNEDOARA
TĂNĂSESCU	IRINA	TribunalulHUNEDOARA
TIMIŞAN	CARMEN MIHAELA	TribunalulHUNEDOARA
VOROVENCI	ANCA- ELENA	TribunalulHUNEDOARA
BOGDAN	ANA ELENA	JudecatoriaDEVA
CONTA	FLAVIUS DACIAN	JudecatoriaDEVA
CREŢU	ANDREA	JudecatoriaDEVA
FODOR	PETER	JudecatoriaDEVA
HOLHOŞ	MARIA ANA	JudecatoriaDEVA
MAROTINEANU	REMUS	JudecatoriaDEVA
MIHAIL	CRISTINA MARIA	JudecatoriaDEVA
NEGREA-DRUCAN	PETRONELA	JudecatoriaDEVA
PÎŢU	ADRIAN CĂTĂLIN	JudecatoriaDEVA
POPESCU	DANIELA	JudecatoriaDEVA
PUŞCAŞU	VOICU IONEL	JudecatoriaDEVA
ŞORTAN	DELIA MIHAELA	JudecatoriaDEVA
TIMOFTE	MARIA – NICOLETA	JudecatoriaDEVA
TRUŞCAN	MĂDĂLINA	JudecatoriaDEVA
ŢIFREA	COSMIN	JudecatoriaDEVA
URSU	GABRIELA MARIA	JudecatoriaDEVA
ZEREŞ	ALEXANDRU FLORIN	JudecatoriaDEVA
CORDUNEANU	NICULINA	JudecatoriaHUNEDOARA
COSTANTEA	RAVECA LOREDANA	JudecatoriaHUNEDOARA
COZI	ADINA	JudecatoriaHUNEDOARA
FLORINCAS	GHEORGHITA	JudecatoriaHUNEDOARA
HERCIU	CRISTINA DANIELA	JudecatoriaHUNEDOARA
NEMEŞ	IOAN	JudecatoriaHUNEDOARA
ORDOG	ERIKA	JudecatoriaHUNEDOARA
TRANDAFIR	GABRIELA	JudecatoriaHUNEDOARA
ANASTASIU	ILEANA	JudecatoriaPETROSANI
BALAURE	IONELA SIMONA	JudecatoriaPETROSANI
BÎSCĂ	CAMELIA ALINA	JudecatoriaPETROSANI
CURUIA	CRISTINA IULIANA	JudecatoriaPETROSANI
DAVID	GIANINA VIORICA	JudecatoriaPETROSANI
DUŢU	NICOLETA LAURA	JudecatoriaPETROSANI
GOLGOTIU	VOINA-MARIA	JudecatoriaPETROSANI
MIHAILESCU	CERASELA VIOLETA	JudecatoriaPETROSANI
MILITARU	LAURENŢIU	JudecatoriaPETROSANI
MILITARU	MARIANA-OTILIA	JudecatoriaPETROSANI
NĂNESCU	ROZALIA MANUELA	JudecatoriaPETROSANI
PETROI	IONELA ROXANA	JudecatoriaPETROSANI
PONYICZKY	GABRIELA	JudecatoriaPETROSANI
TOPORAN	CARMEN RIBANA	JudecatoriaPETROSANI
PAUN	CORINA DANIELA	JudecatoriaBRAD
ROGOVEANU	MONICA	JudecatoriaBRAD
STOICA	MARIAN BOGDAN	JudecatoriaBRAD
MIHAILA	CARMEN-NICOLETA	JudecatoriaHATEG
SABAU	OLGA-MELINDA	JudecatoriaHATEG
ZGREABĂN	ELVIRA	JudecatoriaHATEG
FLOREA	NAPOLEON	JudecatoriaORASTIE
TUDOSIE	MARINA	JudecatoriaORASTIE
ANDREI	VICTORIA	TribunalulSIBIU
BARBU	DANIELA MARIOARA	TribunalulSIBIU
BERGHEZAN	GABRIELA LILIANA	TribunalulSIBIU
BIBU	MARIANA	TribunalulSIBIU
BOCA 	ELENA	TribunalulSIBIU
BREBENEL	ALEXANDRA	TribunalulSIBIU
BUTIUC	CONSTANTIN	TribunalulSIBIU
COMANITA	GHEORGHE	TribunalulSIBIU
CZIKA	DANIELA MARIA	TribunalulSIBIU
DEJUGAN	MARIA	TribunalulSIBIU
DUMITRACHE	VIORICA CLAUDIA	TribunalulSIBIU
FLOREA	ELENA	TribunalulSIBIU
GEORGICA	CARMEN ELENA	TribunalulSIBIU
HAGEANU	CRISTINA CODRUTA	TribunalulSIBIU
LAPADAT	DANIELA RODICA	TribunalulSIBIU
LUCA	DANIELA TEOFILA	TribunalulSIBIU
MARCU	TATIANA	TribunalulSIBIU
OPRIS	MARIA	TribunalulSIBIU
POIANA	ELENA CARMEN	TribunalulSIBIU
POPA	CARMEN MARILENA	TribunalulSIBIU
POPA	LAURA ROXANA	TribunalulSIBIU
RADU	SIMONA	TribunalulSIBIU
RUSU	MARCEL IOAN	TribunalulSIBIU
SAVU	RALUCA ANAMARIA	TribunalulSIBIU
SEBEŞAN	ANDREI VLĂDUŢ	TribunalulSIBIU
SOMANDRA	DUMITRU	TribunalulSIBIU
STANESE	ANDREIA LAURA	TribunalulSIBIU
TICHINDELEAN	MARIOARA	TribunalulSIBIU
TRIFAN	DAN RADU	TribunalulSIBIU
VERZA	ILIE	TribunalulSIBIU
BÂRSAN	CARMEN ELENA	JudecatoriaSIBIU
CHEŢAN	COSMINA MITRUŢA	JudecatoriaSIBIU
DINCĂ	ADELA CORNELIA	JudecatoriaSIBIU
DINCĂ	DIANA	JudecatoriaSIBIU
DRAGOE	STEFANIA	JudecatoriaSIBIU
DRAŞOVEANU	CORINA IONELA	JudecatoriaSIBIU
FĂLĂMAS	NICOLAE	JudecatoriaSIBIU
FILIP	LARISA ANDREEA	JudecatoriaSIBIU
FILIP	VIRGILIU CEZAR	JudecatoriaSIBIU
GREISSING	DIANA CRISTINA	JudecatoriaSIBIU
HANCĂS	MIRELA	JudecatoriaSIBIU
JUMUGĂ	VALENTIN	JudecatoriaSIBIU
LAZĂR	BIANCA MARIA	JudecatoriaSIBIU
LUCUŢA	ADINA MIHAELA	JudecatoriaSIBIU
MORAR - OPRISIU	MARIA	JudecatoriaSIBIU
OLAN	LAURA ELENA	JudecatoriaSIBIU
PALTINEANU	MARIA	JudecatoriaSIBIU
PIROS	FLORICA TANTA	JudecatoriaSIBIU
RADU	SIMONA	JudecatoriaSIBIU
SANTAI	ANDA	JudecatoriaSIBIU
STAICU	LILIANA MARIA	JudecatoriaSIBIU
TURCU	MONICA MIOARA	JudecatoriaSIBIU
VADEANU	FLORIN	JudecatoriaSIBIU
ANCHIDIN	ADRIANA	JudecatoriaMEDIAS
ANCHIDIN	LIVIU	JudecatoriaMEDIAS
BAIESIU	MIHAELA CRISTINA	JudecatoriaMEDIAS
HANES	ONISIE	JudecatoriaMEDIAS
MADARASI-PAP	CARMEN	JudecatoriaMEDIAS
OLTEAN	GABRIEL - ARGHIL	JudecatoriaMEDIAS
OLTEANU	DANIELA	JudecatoriaMEDIAS
SUCIU	DANIELA IOANA	JudecatoriaMEDIAS
VISA	ELENA LILIANA	JudecatoriaMEDIAS
VISA	IOAN	JudecatoriaMEDIAS
ZOLTAN	MIRELA	JudecatoriaMEDIAS
CRĂCIUN	DANIELA - SORINA	JudecatoriaAGNITA
NISTOR	ANDREI	JudecatoriaAGNITA
MAZILU	MARIUS IOAN	JudecatoriaAVRIG
MUNTEAN	CODRUŢA - ELENA	JudecatoriaAVRIG
VEŞTEMEAN	ALINA IOANA	JudecatoriaAVRIG
VÎLCU	NATALIA PETRONELA	JudecatoriaAVRIG
DINESCU	ANDREEA ANGELICA	JudecatoriaSALISTE
DUMITRACHE	MIOARA CRISTINA	JudecatoriaSALISTE
VACARU SORA	ELENA SIMONA	JudecatoriaSALISTE
VULCAN	MARIA	JudecatoriaSALISTE
ADRIAN	BOGDAN ION	CurteadeApelBACAU
ALBESCU	LOREDANA LENUŢA	CurteadeApelBACAU
ANTI	SILVIU	CurteadeApelBACAU
ASTEFĂNESEI	PETRINA-MANUELA	CurteadeApelBACAU
BUSUIOC 	ANAMARIA-MONICA	CurteadeApelBACAU
CĂLIMAN	CARMEN	CurteadeApelBACAU
CHIRIAC 	MARIA-VIOLETA	CurteadeApelBACAU
CIOBANU	LILIANA	CurteadeApelBACAU
CIOBANU	SORINA	CurteadeApelBACAU
CIOPRAGA	GABRIELA - MONA	CurteadeApelBACAU
GALAVAN	ADINA CĂTĂLINA	CurteadeApelBACAU
GROSU	VALERICA NICULINA	CurteadeApelBACAU
IACOBUŢ	NECULAI - CĂTĂLIN	CurteadeApelBACAU
LUNGU TRANOLE	OLGUŢA	CurteadeApelBACAU
MARCOVICI	DANTEŞ	CurteadeApelBACAU
MENGONI	ARIN ALEXANDRU	CurteadeApelBACAU
MOGLAN	LĂCRĂMIOARA	CurteadeApelBACAU
NAPA	MORINA	CurteadeApelBACAU
NEGOIŢĂ	CAMELIA	CurteadeApelBACAU
NOVAC 	LILIANA	CurteadeApelBACAU
PĂRĂU	DANIELA	CurteadeApelBACAU
PINTEA	VASILICĂ	CurteadeApelBACAU
PIRJOL-NASTASE	DORU-OCTAVIAN	CurteadeApelBACAU
PRALEA	VASILICĂ OVIDIU	CurteadeApelBACAU
POCOVNICU 	DUMITRU	CurteadeApelBACAU
POPESCU	CLAUDIA	CurteadeApelBACAU
ROMAŞCANU	SORINA	CurteadeApelBACAU
ŞERBAN	CĂTĂLIN	CurteadeApelBACAU
STĂNIŞOR	VERA	CurteadeApelBACAU
ŞTEFĂNESCU	CEZAR	CurteadeApelBACAU
VĂDANA	MONICA	CurteadeApelBACAU
VIZITEU	LILIANA - CAMELIA	CurteadeApelBACAU
ANTOHE	GABRIELA	TribunalulBACAU
ANTOHI	GRETA	TribunalulBACAU
APETROAEI	RALUCA- IOANA	TribunalulBACAU
ARHIP	ALINA RAMONA	TribunalulBACAU
BUDEANU	VASILE SORIN	TribunalulBACAU
BUMBU	ROBERT CONSTANTIN	TribunalulBACAU
CIOCAN	GHEORGHE	TribunalulBACAU
COCIOIU	CRISTINA	TribunalulBACAU
COSTEA	ANGELICA	TribunalulBACAU
DĂNĂILĂ	CORNELIA	TribunalulBACAU
DĂNILĂ	CODRINA LĂCRĂMIOARA	TribunalulBACAU
DOGARU	OANA ALINA	TribunalulBACAU
DORNEANU	CARMEN GEANINA	TribunalulBACAU
FESAN	PAULA CRISTINA	TribunalulBACAU
FESAN	CĂTĂLINA LOREDANA	TribunalulBACAU
GIREADĂ	DANIELA	TribunalulBACAU
GRANCEA	GABRIEL	TribunalulBACAU
GRANCEA	LUMINIŢA	TribunalulBACAU
GRECU	SIMONA LOREDANA	TribunalulBACAU
HRITCU	LENUŢA	TribunalulBACAU
MAGHIARU	MARGARETA	TribunalulBACAU
MATEIŞ	PETRONELA - MARIA	TribunalulBACAU
MUNTEANU	MARIA	TribunalulBACAU
NIMINEŢ	CĂTĂLIN	TribunalulBACAU
OBOROCIANU	MARIA	TribunalulBACAU
PASCARU	BRÎNDUŞA	TribunalulBACAU
PĂTRAŞC BĂLAN	IONELA DIANA	TribunalulBACAU
PETRARU	ELENA	TribunalulBACAU
PÎNZARU	OANA GEORGETA	TribunalulBACAU
POCOVNICU	IOANA - LILIANA	TribunalulBACAU
PRUTEANU 	CRISTINA MARIANA	TribunalulBACAU
RADU	CRISTINA - MĂDĂLINA	TribunalulBACAU
RUSU DONIGHEVICI	DANIELA	TribunalulBACAU
SAVA	LIDIA CARMEN RODICA	TribunalulBACAU
SPIRIDON	CRISTINA CAMELIA	TribunalulBACAU
ŞTEFANESCU	DANA	TribunalulBACAU
VELESCU	AURICA	TribunalulBACAU
AGAFIŢEI	ŞTEFAN	JudecatoriaBACAU
BĂISAN	IULIANA	JudecatoriaBACAU
BURDUJA	ELENA ANDREEA	JudecatoriaBACAU
BORDEIANU	BIANCA ELENA	JudecatoriaBACAU
CHIRIAC	IULIA MONICA	JudecatoriaBACAU
CHIRIAC – MANOLE	MANUEL	JudecatoriaBACAU
COLIBABA	TATIANA MARIA	JudecatoriaBACAU
COTORANU	DIANA	JudecatoriaBACAU
CRĂCIUN	MIHAELA	JudecatoriaBACAU
CURPĂN	VASILE  SORIN	JudecatoriaBACAU
DABIJA	MIHAELA	JudecatoriaBACAU
DAMIAN	MIA CRISTINA	JudecatoriaBACAU
DĂNĂLACHE	MARIA SORINA	JudecatoriaBACAU
DOGAR	ANDREIA SIMONA	JudecatoriaBACAU
DOLGOŞ	PAUL DORIN	JudecatoriaBACAU
ENACHE 	SILVIU CĂTĂLIN	JudecatoriaBACAU
IONESCU	CAMELIA	JudecatoriaBACAU
IVESCU	IULIA MĂDĂLINA	JudecatoriaBACAU
JERCAN	PETRONELA MIHAELA	JudecatoriaBACAU
LEONTE	IRINA ELENA	JudecatoriaBACAU
LUPAŞCU	SERGIU	JudecatoriaBACAU
MĂGIRESCU	MARIA LOREDANA	JudecatoriaBACAU
MĂRMUREANU	SILVIA	JudecatoriaBACAU
MENGONI	SILVIA	JudecatoriaBACAU
MUNTEANU 	VIOREL	JudecatoriaBACAU
PALADE	ROXANA MIHAELA	JudecatoriaBACAU
PĂDURARU	LAURENŢIU	JudecatoriaBACAU
PANFIL	CARMEN SIMONA	JudecatoriaBACAU
PÎRJOL - NĂSTASE	ELENA	JudecatoriaBACAU
POPOVENIUC	ALEXANDRU	JudecatoriaBACAU
POPOVICI	ANDREEA - MANUELA	JudecatoriaBACAU
PUSCAŞU	ALINA - CRISTINA	JudecatoriaBACAU
ŞTEFĂNESCU	ROXANA - IRINA	JudecatoriaBACAU
ŢIMIRAŞ	CIPRIAN - CONSTANTIN	JudecatoriaBACAU
ADAM	DANIEL EUGEN	JudecatoriaONESTI
ANDRONACHE	GHEORGHE	JudecatoriaONESTI
ANGHEL	ION	JudecatoriaONESTI
ANGHEL	LUMINIŢA	JudecatoriaONESTI
ASAVEI	ADRIAN	JudecatoriaONESTI
BĂDĂU	LILIANA	JudecatoriaONESTI
CRĂCIUN 	ANCA	JudecatoriaONESTI
LUPU 	MARIA CRISTINA	JudecatoriaONESTI
POPA	DANIELA	JudecatoriaONESTI
PURICE	SIMINA	JudecatoriaONESTI
PUŞCAŞU	LILIANA MIRELA	JudecatoriaONESTI
STROE - MUNTEANU	LILIANA	JudecatoriaONESTI
SMARANDI	COSTIN	JudecatoriaONESTI
SMARANDI 	LAURA	JudecatoriaONESTI
ALEXANDRU	MAGDALENA LUIS	JudecatoriaMOINESTI
CĂILEAN	IOAN DĂNUŢ	JudecatoriaMOINESTI
DARIE	DANIEL	JudecatoriaMOINESTI
FILOTE	IOANA ANA MARIA	JudecatoriaMOINESTI
GROAPA 	CARMEN ANEMARIA	JudecatoriaMOINESTI
NEGRII	LUMINIŢA GABRIELA	JudecatoriaMOINESTI
PAŢILEA	CARMEN  NELA	JudecatoriaMOINESTI
PĂTRAŞC BĂLAN	MIHAI CRISTINEL	JudecatoriaMOINESTI
PRICHICI	ANDREEA	JudecatoriaMOINESTI
SANDU	MARIA IRINA	JudecatoriaMOINESTI
STAN	ANCA MĂDĂLINA	JudecatoriaMOINESTI
MAFTEI	SMARANDA CLAUDIA	JudecatoriaPODUTURCULUI
MÎRŢ	MIHAELA	JudecatoriaPODUTURCULUI
VACARIU	BOGDAN CONSTANTIN	JudecatoriaPODUTURCULUI
ARONESCU	NICOLAIE TIBERIU	JudecatoriaBUHUSI
CANDET	ANA-MARIA	JudecatoriaBUHUSI
IONIŢĂ	MIHAELA ADINA	JudecatoriaBUHUSI
PĂCURARU	ANA	JudecatoriaBUHUSI
ACIOBANITEI	MARIA SILVIA	TribunalulNEAMT
AMZA	ELENA NICOLETA	TribunalulNEAMT
ATUDOSIEI	MARIA	TribunalulNEAMT
BACIU	VALENTINA	TribunalulNEAMT
BALTAG	VASILE	TribunalulNEAMT
BALTAG	GABRIELA	TribunalulNEAMT
BOTEZATU	CRISTIAN EDUARD	TribunalulNEAMT
BOTEZATU	ELENA GABRIELA	TribunalulNEAMT
BUZDEA	CARMEN	TribunalulNEAMT
CÎRJĂ	LENUŢA	TribunalulNEAMT
CORNEA	MARIANA	TribunalulNEAMT
DUMITREASA	CRISTINEL	TribunalulNEAMT
ENACHE	OANA - GEORGIANA	TribunalulNEAMT
FILIOREANU	LAURA - ELENA	TribunalulNEAMT
IVĂNUŞCA	MARIA	TribunalulNEAMT
MAGDALINA	DAN	TribunalulNEAMT
MAGDALINA 	CONSTANTIN	TribunalulNEAMT
MÂNGÂŢĂ	ANA	TribunalulNEAMT
FLOREA	CRISTINA	TribunalulNEAMT
MITROFAN	DANIELA	TribunalulNEAMT
MITROFAN	IULIAN	TribunalulNEAMT
MURARIU	DOINA	TribunalulNEAMT
ONIŞOR	MIHAI DANIEL	TribunalulNEAMT
PĂDURARU	CARMEN ELENA	TribunalulNEAMT
PĂVĂLUŢĂ	IRENA CONSUELA	TribunalulNEAMT
SANDU	MARILENA DANIELA	TribunalulNEAMT
SERGHEI	CĂTĂLIN	TribunalulNEAMT
STRUGARU	DOINA	TribunalulNEAMT
TOPLICEANU	NECULAI	TribunalulNEAMT
UNGUREANU	SILVIU	TribunalulNEAMT
VASILIU	MARIA	TribunalulNEAMT
AFLOAREI	OANA	JudecatoriaPIATRANEAMT
APOSTOL	IULIA EMILIA	JudecatoriaPIATRANEAMT
AMZA	EMIL MIRCEA	JudecatoriaPIATRANEAMT
BUMBU	MIHAELA MARIA	JudecatoriaPIATRANEAMT
BUZATU	ELENA ROXANA	JudecatoriaPIATRANEAMT
CHITAŞ 	VASILE VIOREL	JudecatoriaPIATRANEAMT
CHIRUŢĂ	MIHAELA ANDREEA	JudecatoriaPIATRANEAMT
DUMITRIU	CRISTINA	JudecatoriaPIATRANEAMT
IONESCU 	FLORINA - CARMEN	JudecatoriaPIATRANEAMT
IRINA	CĂTĂLINA	JudecatoriaPIATRANEAMT
ISOPESCU	CARMEN MELANIA	JudecatoriaPIATRANEAMT
JITARU	MARIANA	JudecatoriaPIATRANEAMT
BOŢU	PETRONELA	JudecatoriaPIATRANEAMT
MORMOE	CÃTÃLIN - MIREL	JudecatoriaPIATRANEAMT
MOROIU	LAURA	JudecatoriaPIATRANEAMT
MUNTEANU	ADINA DUMITRIŢA	JudecatoriaPIATRANEAMT
NICODIM	MIHAELA CONSTANŢA	JudecatoriaPIATRANEAMT
PAISA	IULIA	JudecatoriaPIATRANEAMT
RĂDUCU	MARIA	JudecatoriaPIATRANEAMT
TENTIUC	ELLZICA ELENA	JudecatoriaPIATRANEAMT
UŢĂ	ANA-MARIA	JudecatoriaPIATRANEAMT
VASILIU	CLAUDIA-VERONICA	JudecatoriaPIATRANEAMT
APETREI	MIRELA	JudecatoriaROMAN
BĂRBIERU	MARCEL GRIGORE	JudecatoriaROMAN
BÎRJOVANU	CRISTIAN	JudecatoriaROMAN
BÎRJOVANU	LUMINITA	JudecatoriaROMAN
BLĂNARIU	ANCUŢA	JudecatoriaROMAN
ENE	LAURA - ELENA	JudecatoriaROMAN
FINICĂ	ADRIAN OCTAVIAN	JudecatoriaROMAN
IACOB	VERONICA	JudecatoriaROMAN
LUNGU	LUCIAN	JudecatoriaROMAN
SAMSON	IRINA SIMONA	JudecatoriaROMAN
SMEU	VASILE	JudecatoriaROMAN
TĂLMĂCEL	PETRUŢA GABRIELA	JudecatoriaROMAN
VIERIU	IOAN	JudecatoriaROMAN
AVASILCĂI	VICTORIA	JudecatoriaTARGUNEAMT
CRAIU	LUMINIŢA-MONICA	JudecatoriaTARGUNEAMT
NICA	ILONA	JudecatoriaTARGUNEAMT
OLARU	ALINA CAMELIA	JudecatoriaTARGUNEAMT
SÂRGHIUŢĂ	FLORIN	JudecatoriaTARGUNEAMT
TOPLICEANU	IOANA	JudecatoriaTARGUNEAMT
URSACHI	IONELA CARMEN	JudecatoriaTARGUNEAMT
URSU 	ANDREEA SIMONA	JudecatoriaTARGUNEAMT
ANDRIEŞ	RODICA	JudecatoriaBICAZ
JUGARU	RALUCA ELENA	JudecatoriaBICAZ
LABIŞ	ALINA MARCELA	JudecatoriaBICAZ
LUCA	CRISTIAN NICOLAE	JudecatoriaBICAZ
PETRESCU	IOAN	JudecatoriaBICAZ
ALEXANDRU	MIHAELA	CurteadeApelBRASOV
BARBU	ELENA	CurteadeApelBRASOV
BARBU	SILVIU GABRIEL	CurteadeApelBRASOV
BOUREANU	OANA MARIA	CurteadeApelBRASOV
BUJAN	CARMEN	CurteadeApelBRASOV
BUTNARU	LORENŢA ADRIANA	CurteadeApelBRASOV
CEOLPAN	MIRELA	CurteadeApelBRASOV
CIAPA	CLARA ELENA	CurteadeApelBRASOV
COMŞA	GABRIELA	CurteadeApelBRASOV
COMŞA	MARCELA	CurteadeApelBRASOV
COSMA	MARIUS-DANIEL	CurteadeApelBRASOV
DARABANĂ	MIHAELA	CurteadeApelBRASOV
DUMITRACHE	ADINA PRETORIA	CurteadeApelBRASOV
EPURE 	CONSTANTIN	CurteadeApelBRASOV
FETEANU	LAURA-ANTOANETA	CurteadeApelBRASOV
FILIP	MANUELA	CurteadeApelBRASOV
FRANGULOIU	SIMONA-MIHAELA	CurteadeApelBRASOV
GAVRILĂ	SIMONA PETRINA	CurteadeApelBRASOV
GHIGHECI	COSTEL CRISTINEL	CurteadeApelBRASOV
GRIGORESCU	NICOLETA	CurteadeApelBRASOV
HĂDĂREAN	NICOLETA	CurteadeApelBRASOV
JURAVSCHI	ELENA- CAMELIA	CurteadeApelBRASOV
LIŢĂ	MARIUS GABRIEL	CurteadeApelBRASOV
LOHĂNEL	MIHAIL	CurteadeApelBRASOV
MANDU	ALINA CONSTANŢA	CurteadeApelBRASOV
MIHAI	MARIA IULIANA	CurteadeApelBRASOV
MILU	RAMONA GRAŢIELA	CurteadeApelBRASOV
MUNTEANU	AURELIA	CurteadeApelBRASOV
PÎRVULESCU	ANCA-ELENA	CurteadeApelBRASOV
POPA	GEORGETA-LAURA	CurteadeApelBRASOV
RADU	MIRENA-MIHAELA	CurteadeApelBRASOV
SPĂRIOS	DEMIS-MARIUS	CurteadeApelBRASOV
ŞERBAN	ALEXANDRU	CurteadeApelBRASOV
ŞERBAN	MIRELA	CurteadeApelBRASOV
STEFĂNIŢĂ	GABRIEL	CurteadeApelBRASOV
ŞTEFĂNIŢĂ	CRISTINA	CurteadeApelBRASOV
STOIAN 	ALINA GABRIELA	CurteadeApelBRASOV
TICĂ	MARIA-CARMEN	CurteadeApelBRASOV
TÎNŢ	NICOLETA-MARGARETA	CurteadeApelBRASOV
ŢĂRMURE 	IOANA	CurteadeApelBRASOV
VODĂ	CODRUŢA ISABELLA	CurteadeApelBRASOV
ADAM	ANCA-ROXANA	TribunalulBRASOV
BENEGUI	BOGDAN	TribunalulBRASOV
BERBECARIU	ANGELICA	TribunalulBRASOV
BONCIU	MANUELA CRISTINA	TribunalulBRASOV
BORICEAN	DANIELA	TribunalulBRASOV
BUSIOC	ION	TribunalulBRASOV
CADEA	MARIUS ROBERT	TribunalulBRASOV
CIOLACU	CRISTINA GABRIELA	TribunalulBRASOV
CONŢ	SIMONA IOANA	TribunalulBRASOV
DEGAN POP	CARMEN	TribunalulBRASOV
DETEŞANU	MONICA-VIORELIA	TribunalulBRASOV
DUMITRU	MIHAELA-GEORGETA	TribunalulBRASOV
ENACHE	SIMONA LILIANA	TribunalulBRASOV
FAGHI	NICOLETA MINODORA	TribunalulBRASOV
FLOREA	CRISTINA-ANCA	TribunalulBRASOV
GÂRLONŢA	ANA	TribunalulBRASOV
IACOB	CORNELIA	TribunalulBRASOV
IONEL	MIA-IRINA	TribunalulBRASOV
IONESCU	ANAMARIA MAGDALENA	TribunalulBRASOV
LIŢĂ	IONELA	TribunalulBRASOV
LUPŞOR	MIHAELA	TribunalulBRASOV
MATEI	SIMONA ŞTEFANIA	TribunalulBRASOV
MIOC	NICOLETA-ALINA	TribunalulBRASOV
MOLDOVAN	DUMITRU DANIEL	TribunalulBRASOV
MOŞ	PETRINA	TribunalulBRASOV
MOŞ	VASILE	TribunalulBRASOV
NEGULESCU	SIMONA	TribunalulBRASOV
NICULEASA	DANIELA	TribunalulBRASOV
OLTEAN	MIHAELA	TribunalulBRASOV
ONCIOIU	ANDREEA CATALINA	TribunalulBRASOV
OPREA	SILVIU	TribunalulBRASOV
POP	OTILIA-DIANA	TribunalulBRASOV
ROPOTĂ	CRISTINA MARIA	TribunalulBRASOV
RUSU	DIANA RALUCA	TribunalulBRASOV
SMARANDACHE	CARMEN-TEODORA	TribunalulBRASOV
SOLCOI	CARMEN OANA	TribunalulBRASOV
STROIA	LAURA	TribunalulBRASOV
TARTLER	ELENA-MARIA	TribunalulBRASOV
TOCĂNIE	ALINA-CAMELIA	TribunalulBRASOV
URS	DANIELA ELENA	TribunalulBRASOV
VÎRGOLICI	TIBERIU-ADRIAN	TribunalulBRASOV
VOINESCU	AURICA	TribunalulBRASOV
ZUP	MIHAELA	TribunalulBRASOV
ACHTEN	RODICA-LAURA	JudecatoriaBRASOV
ALDEA	ANGLIANA ELENA	JudecatoriaBRASOV
ARAMĂ	MIRELA	JudecatoriaBRASOV
ASMARANDEI	ALEXANDRU	JudecatoriaBRASOV
BĂCIOIU	LUCICA	JudecatoriaBRASOV
BANU	ELENA-RODICA	JudecatoriaBRASOV
BEUDEAN	ELENA	JudecatoriaBRASOV
BOTEZATU	ADINA CERASELA	JudecatoriaBRASOV
CĂLIN	NICOLETA	JudecatoriaBRASOV
CHISCOP	CRISTIN ANTONIO	JudecatoriaBRASOV
GAVRILĂ	CIPRIAN	JudecatoriaBRASOV
GHEORGHIU	ANCA	JudecatoriaBRASOV
GHIDARCEA	LUCIAN CRISTIAN	JudecatoriaBRASOV
ISAC 	MARIAN MARIUS	JudecatoriaBRASOV
LUCA	MIHAELA IULIA	JudecatoriaBRASOV
LUCHIAN	REBECA - SILVIA	JudecatoriaBRASOV
DOGARU	ILEANA ROXANA	JudecatoriaBRASOV
MAGDAŞ	ALEXANDRA	JudecatoriaBRASOV
MARINESCU	LIVIU-DUMITRU	JudecatoriaBRASOV
MARUŞCA	BOGDANA MARIA	JudecatoriaBRASOV
MEROIU	GEORGIANA ANCA	JudecatoriaBRASOV
MOISA	CRISTINA MARILENA	JudecatoriaBRASOV
MOLDOVAN	DANA -IULIANA	JudecatoriaBRASOV
MORARU	MIHAILA	JudecatoriaBRASOV
MUNTEANU	CRISTINA MONICA	JudecatoriaBRASOV
NICA	ALINA	JudecatoriaBRASOV
NISTOR	CĂTĂLINA	JudecatoriaBRASOV
OPREA	CĂTĂLIN VASILICĂ	JudecatoriaBRASOV
POPESCU	LAURA-SIMONA	JudecatoriaBRASOV
PRUNARU	CRISTINA MARIA	JudecatoriaBRASOV
RACMAN	ALINA ELENA	JudecatoriaBRASOV
ROMANIUC	CORNELIA ELENA	JudecatoriaBRASOV
SEVERINCU	VLAD IONUŢ	JudecatoriaBRASOV
SIMION	MIHAELA	JudecatoriaBRASOV
SÎMPETRU	ANDA-VALERIA	JudecatoriaBRASOV
SPĂTĂCEAN	LIA	JudecatoriaBRASOV
STROIU	OANA	JudecatoriaBRASOV
TROFIN	CORINA	JudecatoriaBRASOV
TOGAN	CARMEN DENISA	JudecatoriaBRASOV
VĂLEANU	IONELA	JudecatoriaBRASOV
VIDAEFF	ADRIANA RODICA	JudecatoriaBRASOV
		
BOERIU	GEORGETA	JudecatoriaFAGARAS
BOERIU	MIRCEA-AUREL	JudecatoriaFAGARAS
BOŞTEAN-OLARIU	MARIA-LAURA	JudecatoriaFAGARAS
DEBU	LIVIA	JudecatoriaFAGARAS
DEJENARIU	ADINELA	JudecatoriaFAGARAS
MUŞINOI	CRISTINA GRAŢIELA	JudecatoriaFAGARAS
PANDREA	MONICA GAROFIŢA	JudecatoriaFAGARAS
PEPTEA	HORIA ADRIAN	JudecatoriaFAGARAS
TIMOFTE	MIHAELA MARIANA	JudecatoriaFAGARAS
ADAM	MARIANA	JudecatoriaRUPEA
COJOCARU	VANESSA GEORGINA	JudecatoriaRUPEA
PRICINĂ	CONSTANŢA	JudecatoriaRUPEA
BEJAN	ANDREEA IONELA	JudecatoriaZARNESTI
CAZAC	ANCA	JudecatoriaZARNESTI
IOVA	ELENA	JudecatoriaZARNESTI
MIHĂILĂ	SORIN	JudecatoriaZARNESTI
MACOVEI	MONICA	JudecatoriaZARNESTI
TERCIU	SIMONA	JudecatoriaZARNESTI
ANDREI	CAMELIA	TribunalulCOVASNA
BENEGUI	ALEXANDRA DANIELA	TribunalulCOVASNA
CODREANU	MELINDA DALMA	TribunalulCOVASNA
DUMITRU	CLAUDIA	TribunalulCOVASNA
LOGIGAN	CARMEN-MIRELA	TribunalulCOVASNA
MIKLOS	ERZSEBET	TribunalulCOVASNA
MUNTEANU	COSMIN TRAIAN	TribunalulCOVASNA
ORĂŞTEANU	NICOLAE	TribunalulCOVASNA
ORDOG	LORAND-ANDRAS	TribunalulCOVASNA
RUSU	IOAN-CATALIN	TribunalulCOVASNA
UŢĂ	GABRIEL	TribunalulCOVASNA
VELICAN	IOAN ADRIAN	TribunalulCOVASNA
VELICAN	MARIA-DANIELA	TribunalulCOVASNA
ZAH	RAMONA IOANA	TribunalulCOVASNA
BARBU	TEODOR MARIAN	JudecatoriaSFANTUGHEORGHE
BARTA	KINGA AGOTA	JudecatoriaSFANTUGHEORGHE
BĂLAN	LAURENŢIU MIHAI	JudecatoriaSFANTUGHEORGHE
BĂRBULESCU	CODRUŢ MARIAN	JudecatoriaSFANTUGHEORGHE
CHIPER	JANICA	JudecatoriaSFANTUGHEORGHE
DANCĂ	ECATERINA OANA	JudecatoriaSFANTUGHEORGHE
GÎŢĂ	ANA MARIA	JudecatoriaSFANTUGHEORGHE
MAROTI - KOVACS	ILDIKO	JudecatoriaSFANTUGHEORGHE
MAGHIAR	MARIA GABRIELA	JudecatoriaSFANTUGHEORGHE
MOLDOVEANU	OANA MEDA	JudecatoriaSFANTUGHEORGHE
BUTA	MIHAELA CARLA	JudecatoriaTARGUSECUIESC
FORRO FAZAKAŞ	CSILLA RITA	JudecatoriaTARGUSECUIESC
KOVACS	SIMONA	JudecatoriaTARGUSECUIESC
RAICEA	LIVIU	JudecatoriaTARGUSECUIESC
CRĂCIUN	MARIANA LIZABELA	JudecatoriaINTORSURABUZAULUI
SOLOVĂSTRU	GEORGE	JudecatoriaINTORSURABUZAULUI
TECIU	MARINELA	JudecatoriaINTORSURABUZAULUI
CHISCOP	ANDA MAGDALENA	TribunalulpentruminoriSifamilieBRASOV
IACUBA	ANDREI	TribunalulpentruminoriSifamilieBRASOV
ILIE	IZABELA-NICOLETA	TribunalulpentruminoriSifamilieBRASOV
PĂDURARIU	ALINA NICOLETA	TribunalulpentruminoriSifamilieBRASOV
SZIKSZAY	RAMONA DELIDA	TribunalulpentruminoriSifamilieBRASOV
AL HAJJAR	SIMONA MIHAELA	CurteadeApelCLUJ
ANDREI	AXENTE IRINEL	CurteadeApelCLUJ
ANDREIEŞ	VIOREL - VIRGIL	CurteadeApelCLUJ
BĂLDEAN	DENISA LIVIA	CurteadeApelCLUJ
BOBOŞ	SERGIU CĂTĂLIN	CurteadeApelCLUJ
BOER	MARIA	CurteadeApelCLUJ
BUDIU	MIRELA AGOTA	CurteadeApelCLUJ
CÂMPEAN	ANAMARIA	CurteadeApelCLUJ
CHICHISAN	AUGUSTA MARIA	CurteadeApelCLUJ
CHIŞ 	IOAN DANIEL	CurteadeApelCLUJ
CHIŞ	ANDREA ANNAMARIA	CurteadeApelCLUJ
CHITIDEAN 	GHEORGHE VALENTIN	CurteadeApelCLUJ
CONT	CARMEN -MARIA	CurteadeApelCLUJ
COVRIG	ANA	CurteadeApelCLUJ
DÂRJAN	TRAIAN	CurteadeApelCLUJ
DIACONESCU	MONICA	CurteadeApelCLUJ
DIACONESCU	SERGIU	CurteadeApelCLUJ
DIMA	LAURA MARIA	CurteadeApelCLUJ
DUŞA	RADU RAREŞ	CurteadeApelCLUJ
GÎRBOVAN 	DANA CRISTINA	CurteadeApelCLUJ
GOJA	VASILE	CurteadeApelCLUJ
GRIGA	DANIELA	CurteadeApelCLUJ
GRUNEA	VASILE - GHEORGHE	CurteadeApelCLUJ
HANZER	PARASCHIVA LUMINIŢA	CurteadeApelCLUJ
HRUDEI 	MARIA	CurteadeApelCLUJ
IACUBA	MIHAELA ANGELICA	CurteadeApelCLUJ
IDRICEANU	CLAUDIA MIRELA	CurteadeApelCLUJ
ILIES	IOANA CLAUDIA	CurteadeApelCLUJ
ION	ANCA MIHAELA	CurteadeApelCLUJ
IONESCU	ANA	CurteadeApelCLUJ
IUGA	MONICA ILEANA	CurteadeApelCLUJ
LUPEA	ADINA DARIA	CurteadeApelCLUJ
MARIAN	NICOLAE	CurteadeApelCLUJ
MARIN	ALEXANDRINA AMALIA	CurteadeApelCLUJ
MĂNĂSTIREANU	CRISTINA	CurteadeApelCLUJ
MANGO	LIVIA MARCELA	CurteadeApelCLUJ
MAGYAROSI	IOANA ROZALIA	CurteadeApelCLUJ
MARUSCIAC	DELIA -ANA	CurteadeApelCLUJ
MITEA	VALENTIN	CurteadeApelCLUJ
MOLDOVAN	IULIANA	CurteadeApelCLUJ
MORAR	IOANA -CRISTINA	CurteadeApelCLUJ
NĂSUI	GABRIEL ADRIAN	CurteadeApelCLUJ
NISTOR	ANTOANETA TANIA	CurteadeApelCLUJ
POP	ANCA ADRIANA	CurteadeApelCLUJ
PURICE	DELIA	CurteadeApelCLUJ
PUSCASU	DANUSIA	CurteadeApelCLUJ
RODINA	MONICA	CurteadeApelCLUJ
RUS 	SERGIU LEON	CurteadeApelCLUJ
SĂRĂCUT	MIHAELA	CurteadeApelCLUJ
SISERMAN	SORINA	CurteadeApelCLUJ
SORTAN	MONICA IOANA	CurteadeApelCLUJ
STURZA 	LIVIA DANIELA	CurteadeApelCLUJ
TĂMAS	FLOAREA	CurteadeApelCLUJ
TRIPON	IOANA	CurteadeApelCLUJ
UNGUR	LIVIU	CurteadeApelCLUJ
VITOS	MARTA CARMEN	CurteadeApelCLUJ
BERARI	REGHINA IOANA	TribunalulBISTRITANASAUD
BERBECARIU	DANIELLA	TribunalulBISTRITANASAUD
BOLBOŞ	IBOLYA SZENDE	TribunalulBISTRITANASAUD
BUJOR	LĂCRIMIOARA TINA	TribunalulBISTRITANASAUD
BULEA	MARIUS / LUCIAN	TribunalulBISTRITANASAUD
CHECEC	VIRGIL- PETRU	TribunalulBISTRITANASAUD
FRENTIU	GABRIELA -CRISTINA	TribunalulBISTRITANASAUD
GĂUREAN	ADINA	TribunalulBISTRITANASAUD
IACOB	CORINA	TribunalulBISTRITANASAUD
LAZAR	MARIANA-VIOLETA	TribunalulBISTRITANASAUD
LINUL	DIANA - EMILIANA	TribunalulBISTRITANASAUD
MARICA	ANCA PETRUŢA	TribunalulBISTRITANASAUD
MARICA	FLORINEL MACIDON	TribunalulBISTRITANASAUD
NĂSCUTIU	CAMELIA VASILICA	TribunalulBISTRITANASAUD
PĂRĂUAN	IOAN	TribunalulBISTRITANASAUD
PETRISOR	ALEXANDRU -DORIN	TribunalulBISTRITANASAUD
PREDA	LILIANA -ELISABETA	TribunalulBISTRITANASAUD
PUTURA	OVIDIU	TribunalulBISTRITANASAUD
SIMIONESCU	ILDIKO	TribunalulBISTRITANASAUD
URSU	ILIE	TribunalulBISTRITANASAUD
BIRĂU	VLADIMIR	JudecatoriaBISTRITA
BOTU	MUGUREL ARIN	JudecatoriaBISTRITA
CHICHIŞAN	ARTEMIS SIMONA	JudecatoriaBISTRITA
CIOBANU	MIOARA MARIANA	JudecatoriaBISTRITA
COSTEA	RĂZVAN RAREŞ	JudecatoriaBISTRITA
CRISTUREAN	CIPRIAN GABRIEL	JudecatoriaBISTRITA
CROITORIU	CĂTĂLIN	JudecatoriaBISTRITA
JÎRGHIUŢĂ	ANAMARIA	JudecatoriaBISTRITA
JOLDEŞ	LILIANA	JudecatoriaBISTRITA
LĂSLEA	PETRUŢA - DIANA	JudecatoriaBISTRITA
MIHAI	ELENA MIHAELA	JudecatoriaBISTRITA
MITROFAN	IULIANA FLOAREA	JudecatoriaBISTRITA
MOLDOVAN	NICOLETA LAURA	JudecatoriaBISTRITA
MOLDOVAN	LIANA CRISTINA	JudecatoriaBISTRITA
NEMET	DOINA MONICA	JudecatoriaBISTRITA
ORDOG	GABRIELA	JudecatoriaBISTRITA
STANA	ANCA CRISTINA	JudecatoriaBISTRITA
TERTIŞ	LILIANA - MARIA	JudecatoriaBISTRITA
VRÂNCEANU	VOICHIŢA	JudecatoriaBISTRITA
CONSTANTIN	MIHĂIŢĂ	JudecatoriaNASAUD
CORLĂŢEANU	SIMINA	JudecatoriaNASAUD
GURLUI	CLAUDIU MARIUS	JudecatoriaNASAUD
MUNTEANU	DIANA- MARIA	JudecatoriaNASAUD
PÂRLEŢEANU	ANCA RAMONA	JudecatoriaNASAUD
POP	ANGELA TATIANA	JudecatoriaNASAUD
RUS	PETRU	JudecatoriaNASAUD
CEUCĂ	SOFIA OTILIA	JudecatoriaBECLEAN
CUPŞA - KISELEFF	LELIA	JudecatoriaBECLEAN
VLAD	MIHAELA- LUMINIŢA	JudecatoriaBECLEAN
ZBRANCA	DORIN	JudecatoriaBECLEAN
BALINT	CAMELIA VERONICA	TribunalulCLUJ
BELEAN	EMIL	TribunalulCLUJ
BOICIUC	IOANA -NORA	TribunalulCLUJ
BOLCHIŞ	FLORINA SANDA	TribunalulCLUJ
BOTIŞ	VASILE MARIUS	TribunalulCLUJ
BUDISAN	ANCA MARIA	TribunalulCLUJ
BUJOR	MARIA FRANCESCA	TribunalulCLUJ
CĂLUGĂR	ANAMARIA GABRIELA	TribunalulCLUJ
CIMBRUDEAN	CORINA ANCA	TribunalulCLUJ
COCIS	LIANA -ANISOARA	TribunalulCLUJ
DOICA	ALIN FLORIN	TribunalulCLUJ
FIRICEL	LUMINIŢA MARIA	TribunalulCLUJ
GHISOIU	OANA RALUCA	TribunalulCLUJ
ILIES	ARIANA LĂCRIMIOARA	TribunalulCLUJ
JACOTĂ	FLORIN CĂTĂLIN	TribunalulCLUJ
LUCA	EMESE	TribunalulCLUJ
LUPEA	IOAN MARIUS	TribunalulCLUJ
MORNĂILĂ	RAMONA	TribunalulCLUJ
ONCICĂ - SANISLAV 	MARCELA MIHAELA	TribunalulCLUJ
ONEŢ	GEORGETA OLIMPIA	TribunalulCLUJ
PRELIPCEANU	IARINA IOANA	TribunalulCLUJ
RĂDULESCU	ALEXANDRINA IOANA	TribunalulCLUJ
SELEŞIU	ANA SORINA	TribunalulCLUJ
TASCĂ	DAN IOAN	TribunalulCLUJ
TATU	CLAUDIA OANA	TribunalulCLUJ
TATU	DORIN	TribunalulCLUJ
ŢOPAN	ALINA CAMELIA	TribunalulCLUJ
TRESTIAN	SIMONA	TribunalulCLUJ
TROFIN	MONICA	TribunalulCLUJ
URS	PETRU	TribunalulCLUJ
VASILE 	RAMONA CORINA	TribunalulCLUJ
VEREŞ	ROXANA MIHAELA	TribunalulCLUJ
ZDRENGHEA	BOGDAN GEORGE	TribunalulCLUJ
BARBURA TURCU	GEORGE	JudecatoriaCLUJNAPOCA
BIRĂU	ANETA-BEATRICE	JudecatoriaCLUJNAPOCA
BOBU	IONELA ANCA	JudecatoriaCLUJNAPOCA
BULIERIS	NICOLETA FELICIA	JudecatoriaCLUJNAPOCA
BUTA	LUCIAN RAREŞ	JudecatoriaCLUJNAPOCA
CHIDOVEŢ	RODICA	JudecatoriaCLUJNAPOCA
CHIRILA	OCTAVIAN CLAUDIAN	JudecatoriaCLUJNAPOCA
CRISTEA	SIMONA GEORGETA	JudecatoriaCLUJNAPOCA
CRIŞAN	CĂLINA MARIA	JudecatoriaCLUJNAPOCA
DAN	ROXANA	JudecatoriaCLUJNAPOCA
DAMIAN	IRINA GEORGIANA	JudecatoriaCLUJNAPOCA
DARADICS	OANA MARIA	JudecatoriaCLUJNAPOCA
DUMA	IULIA	JudecatoriaCLUJNAPOCA
FĂRCAŞ HÎNGAN	GEORGIANA RODICA	JudecatoriaCLUJNAPOCA
FINŢOC	MARIA - CRSITINA	JudecatoriaCLUJNAPOCA
FOCŞAN	CLAUDIU RAUL	JudecatoriaCLUJNAPOCA
GAGA	IOAN	JudecatoriaCLUJNAPOCA
GUZU	RODICA ELISABETA	JudecatoriaCLUJNAPOCA
IONESCU	CONSTANTINA	JudecatoriaCLUJNAPOCA
ISACU	VERONICA IRINA ANTONIA	JudecatoriaCLUJNAPOCA
IVANCIUC	MIHAI	JudecatoriaCLUJNAPOCA
IVAŞCU	TEODORA LOREDANA	JudecatoriaCLUJNAPOCA
LAZAR	MONICA	JudecatoriaCLUJNAPOCA
MARIAN	MIHĂIŢĂ LUCIAN	JudecatoriaCLUJNAPOCA
MIHAI	SIMONA	JudecatoriaCLUJNAPOCA
MIRCEA	FELICIA	JudecatoriaCLUJNAPOCA
MOLDOVAN 	DANIELA ANCA	JudecatoriaCLUJNAPOCA
MOŞ	ANAMARIA LUMINIŢA	JudecatoriaCLUJNAPOCA
MOT	MARIA -  GABRIELA	JudecatoriaCLUJNAPOCA
NEAMT	IULIANA ALINA	JudecatoriaCLUJNAPOCA
NOJA	CARMEN SIMONA	JudecatoriaCLUJNAPOCA
PAVELESCU	ANCUŢA	JudecatoriaCLUJNAPOCA
PĂSCULEŢ	IOANA	JudecatoriaCLUJNAPOCA
PÎRVU	ECATERINA ELENA	JudecatoriaCLUJNAPOCA
PĂCURAR	VICTORIŢA PAULA	JudecatoriaCLUJNAPOCA
POPA	RUXANDRA MARIA	JudecatoriaCLUJNAPOCA
POPESCU	ADRIAN	JudecatoriaCLUJNAPOCA
POPOVICI	DOINA VIORICA	JudecatoriaCLUJNAPOCA
ROŞU	DIANA GABRIELA	JudecatoriaCLUJNAPOCA
RUS	RAMONA CLAUDIA	JudecatoriaCLUJNAPOCA
RUSU	IOANA MARIA	JudecatoriaCLUJNAPOCA
TRIFAN 	ŞOIMIŢA BIANCA	JudecatoriaCLUJNAPOCA
VELNICIUC - CIUPĂRCĂ	IULIANA - CRISTINA	JudecatoriaCLUJNAPOCA
ALDEA	ANA	JudecatoriaTURDA
ALDEA	SIMONA - TUNDE	JudecatoriaTURDA
BUCEA	CONSTANTINA MARIA	JudecatoriaTURDA
CIOBĂNESCU	IOANA	JudecatoriaTURDA
CIOLPAN	CARMEN RAMONA	JudecatoriaTURDA
COROVEI	CORINA	JudecatoriaTURDA
LOOR	VLAD ALEXANDRU	JudecatoriaTURDA
MACARIE	CORINA MIHAELA	JudecatoriaTURDA
OPRESCU	MUGUREL MARIUS	JudecatoriaTURDA
POP	CRISTINA	JudecatoriaTURDA
PUŞCAŞU	ADRIANA LUCIA	JudecatoriaTURDA
UNGURAŞ	FLORIN BENIAMIN	JudecatoriaTURDA
CATINEAN	CANDIDIA-LAURA	JudecatoriaDEJ
CAZAN	DUMITRIELA RODICA	JudecatoriaDEJ
GHICA	MIHAI ŞTEFAN	JudecatoriaDEJ
IGNA	CORIN - GIULIANO	JudecatoriaDEJ
MÎNZAT	CAMELIA IASMINIA	JudecatoriaDEJ
RUSU	SIMION	JudecatoriaDEJ
CRISTEA	OFELIA DIANA	JudecatoriaHUEDIN
MARC	LILIANA ELENA	JudecatoriaHUEDIN
MATEI	JENI SIMONA	JudecatoriaHUEDIN
TATAR	CALIN	JudecatoriaHUEDIN
FIŢIGĂU	OANA LAVINIA	JudecatoriaGHERLA
GEORGIU	IOAN	JudecatoriaGHERLA
GEORGIU	IOANA LILIANA	JudecatoriaGHERLA
GÎLCĂ	MIHAI IULIAN	JudecatoriaGHERLA
NICOARĂ	MONICA CORINA	JudecatoriaGHERLA
RUSU	DANA IOANA	JudecatoriaGHERLA
STANILĂ	CARMEN	JudecatoriaGHERLA
STANILĂ	FLORIN	JudecatoriaGHERLA
TOCAN	HORIA OVIDIU	JudecatoriaGHERLA
TODEA	ROSINA VALENTINA	JudecatoriaGHERLA
BENDEA	ELENA	TribunalulComercialCLUJ
BOTIŞ	MARIA CAMELIA	TribunalulComercialCLUJ
CENGHER	CAMELIA LILIANA	TribunalulComercialCLUJ
COROIU	SÎNZIANA FELICIA	TribunalulComercialCLUJ
GLIGAN	CLAUDIU	TribunalulComercialCLUJ
GRUNEA	VOICHIŢA LAURA	TribunalulComercialCLUJ
HAMCIUC	DANIELA	TribunalulComercialCLUJ
IVĂNESCU	SIMONA	TribunalulComercialCLUJ
KOSA	NICOLETA-CARMEN	TribunalulComercialCLUJ
MOTU	FLAVIUS-IANCU	TribunalulComercialCLUJ
NICOLESCU	ALINA GABRIELA	TribunalulComercialCLUJ
PĂCURAR	IULIAN	TribunalulComercialCLUJ
SEMAN	DANA - MONICA	TribunalulComercialCLUJ
ALB	CODRUŢA - VIOLETA	TribunalulMARAMURES
BALINT	CAMELIA  MONIKA	TribunalulMARAMURES
BORCUTEAN	NELA	TribunalulMARAMURES
CIUCĂ	VIORICA	TribunalulMARAMURES
CODREA	MARIA	TribunalulMARAMURES
COSTIN	EMIL	TribunalulMARAMURES
DANCI	DORIN	TribunalulMARAMURES
FIŢIGĂU	VASILE ION	TribunalulMARAMURES
GIUROIU	BRANDUSA-DELIA	TribunalulMARAMURES
GIUROIU	CĂTĂLIN - TRAIAN	TribunalulMARAMURES
GONDOR 	ORESIA MARIANA	TribunalulMARAMURES
HOBAN	ANAMARIA - MIHAELA	TribunalulMARAMURES
IELCIU	VIORICA	TribunalulMARAMURES
LIHET	CRISTINA - LAURA	TribunalulMARAMURES
OLTEAN	SIMONA - CAMELIA	TribunalulMARAMURES
OPRIŞ	ALINA CRINA	TribunalulMARAMURES
PAVEL	MARIA -STEFANIA	TribunalulMARAMURES
POP	VIRGINIA	TribunalulMARAMURES
POP	GHIZELA GABRIELA	TribunalulMARAMURES
POP	MIHAI BOGDAN	TribunalulMARAMURES
RUS	ANDREI-CLAUDIU	TribunalulMARAMURES
SIMON	ANTONIU	TribunalulMARAMURES
SIMON	LIGIA RAMONA	TribunalulMARAMURES
SOARE-FARC	ANDA CLAUDIA	TribunalulMARAMURES
STAMATE - TĂMĂŞAN 	ALINA ANA	TribunalulMARAMURES
TIPLEA	DANIELA	TribunalulMARAMURES
WALTNER	ILEANA DANIELA	TribunalulMARAMURES
ABRAHAM	ADRIANA RAMONA	JudecatoriaBAIAMARE
AXENTA	MARCEL	JudecatoriaBAIAMARE
BOLOŞ	IOANA	JudecatoriaBAIAMARE
ENE SOLOMCIUC	AURORA DIANA RAMONA	JudecatoriaBAIAMARE
FARCAŞ	MĂDĂLINA - ELENA	JudecatoriaBAIAMARE
FRANCISC	OVIDIU	JudecatoriaBAIAMARE
FRANCISC	VIANA LIANA	JudecatoriaBAIAMARE
MANOLE	ALEXANDRA MARIA	JudecatoriaBAIAMARE
MARCU	MELANIA ELENA	JudecatoriaBAIAMARE
MARCU	IACOB - CĂTĂLIN	JudecatoriaBAIAMARE
MIHALCA	CRISTINA SIMONA	JudecatoriaBAIAMARE
NEAMŢ	IOAN ILIEŞ	JudecatoriaBAIAMARE
POP	COSMIN CRISTIAN	JudecatoriaBAIAMARE
RADU 	CRISTINA VICTORIA	JudecatoriaBAIAMARE
RADU	DANIELA-DRAGA	JudecatoriaBAIAMARE
SIMA	ELENA MARIA	JudecatoriaBAIAMARE
STAMATE - TĂMĂŞAN	NICOLAE	JudecatoriaBAIAMARE
ŞENDRESCU	DĂNUŢ	JudecatoriaBAIAMARE
ŞTEF	DIANA	JudecatoriaBAIAMARE
UNGUREANU	VIRGINIA	JudecatoriaBAIAMARE
VERDEŞ	ALEXANDRU LUCIAN	JudecatoriaBAIAMARE
ARDELEAN	MIHAELA LIANA	JudecatoriaSIGHETUMARMATIEI
GULUŢĂ	CRISTIAN ROMICĂ	JudecatoriaSIGHETUMARMATIEI
IOVA	CAMELIA EMILIA	JudecatoriaSIGHETUMARMATIEI
NEMEŞ POP	IOAN	JudecatoriaSIGHETUMARMATIEI
PETRARIU	MIRELA ROXANA	JudecatoriaSIGHETUMARMATIEI
STAN	CRISTINA - MARIANA	JudecatoriaSIGHETUMARMATIEI
ULICI	LOREDANA GABRIELA	JudecatoriaSIGHETUMARMATIEI
FĂRÂMĂ	VASILE FLORIN	JudecatoriaVISEUDESUS
LANGTALER	ANA MARIA	JudecatoriaVISEUDESUS
MARIS	GHEORGHE	JudecatoriaVISEUDESUS
MÂNDRU	MIRELA DANIELA	JudecatoriaVISEUDESUS
ŞIMON	MARIANA	JudecatoriaVISEUDESUS
AGOP	MIRCEA	JudecatoriaTARGULAPUS
GRAMA	ELENA	JudecatoriaTARGULAPUS
TULICI	DANIEL MIHAI	JudecatoriaTARGULAPUS
BURNAR	LIVIA	JudecatoriaDRAGOMIRESTI
GAVRIŞ TODINCA	VERONICA ELISABETA	JudecatoriaDRAGOMIRESTI
CĂTUNA	DANIELA	TribunalulSALAJ
CHIS	NICOLAE CLAUDIU	TribunalulSALAJ
DĂRĂBAN	PATRITIU	TribunalulSALAJ
DRĂGAN	GAVRIL	TribunalulSALAJ
HODIŞ	IOANA - DIANA	TribunalulSALAJ
IONESCU	DORINA - DELIA	TribunalulSALAJ
KENDE	MONICA	TribunalulSALAJ
LAZOC	MIRELA TEODORA	TribunalulSALAJ
MOLDOVAN	SORIN	TribunalulSALAJ
POP	ADRIANA - RAMONA	TribunalulSALAJ
POP	RADA MAGDALENA	TribunalulSALAJ
TOMSA	CLAUDIA	TribunalulSALAJ
ŢĂRAN	DARIA BRÂNDUȘA	TribunalulSALAJ
BADEA	CRISTINA MARIA	JudecatoriaZALAU
CHIŞ	DAN ADRIAN	JudecatoriaZALAU
COTÎRLĂ	MIRELA - MIHAELA	JudecatoriaZALAU
LAR	MARIA DANIELA	JudecatoriaZALAU
MARIAN	DORINA ELENA	JudecatoriaZALAU
MOGA	ANAMARIA MIHAELA	JudecatoriaZALAU
NEAGOŞ	SORINA VIORICA	JudecatoriaZALAU
PODAR	CLAUDIU - RARES	JudecatoriaZALAU
POP	ANGHEL MARIAN	JudecatoriaZALAU
PUIU	DANA MARIA	JudecatoriaZALAU
ŞTEF	MARIA CRISTINA	JudecatoriaZALAU
TRIF	CLAUDIA ARABELA	JudecatoriaZALAU
CRISTE	ANCA ADRIANA	JudecatoriaSIMLEULSILVANIEI
MERFU – ARON	DANIELA	JudecatoriaSIMLEULSILVANIEI
SANTAVAN	LILIANA	JudecatoriaSIMLEULSILVANIEI
ARDELEAN	FLAVIUS FLORIN	JudecatoriaJIBOU
MATYUS	GABRIELA ELVIRA	JudecatoriaJIBOU
MOLDOVEANU	COSTIN	JudecatoriaJIBOU
ANGHEL	RĂZVAN	CurteadeApelCONSTANTA
BADULESCU	MARIANA	CurteadeApelCONSTANTA
BONDOC	IRINA	CurteadeApelCONSTANTA
COADĂ	CIPRIAN	CurteadeApelCONSTANTA
COSTEA	MONICA MIOARA	CurteadeApelCONSTANTA
CUCULIS	NASTASIA	CurteadeApelCONSTANTA
DAVIDENCU - ŞERBAN	IULIANA MIHAELA	CurteadeApelCONSTANTA
DELIORGA	CRISTIAN	CurteadeApelCONSTANTA
EPURE	MARIUS - CRISTIAN	CurteadeApelCONSTANTA
FRANGU	ZOITA	CurteadeApelCONSTANTA
GANEA	MIHAELA VIRGINIA	CurteadeApelCONSTANTA
GHEORMA	ELENA CARINA	CurteadeApelCONSTANTA
GHERASIM	ADRIANA ELENA	CurteadeApelCONSTANTA
GRIGORE	ECATERINA	CurteadeApelCONSTANTA
IANCA	ANDREEA	CurteadeApelCONSTANTA
ISPAS	ADRIANA	CurteadeApelCONSTANTA
JIGĂU	CĂTĂLIN	CurteadeApelCONSTANTA
LEFTER	GABRIEL SANDU	CurteadeApelCONSTANTA
LUNGU	VIORICA	CurteadeApelCONSTANTA
MARCU	ELENI CRISTINA	CurteadeApelCONSTANTA
MITEA	DAMIAN MARIUS	CurteadeApelCONSTANTA
MOGA	REVI PAULICA	CurteadeApelCONSTANTA
NĂSTASE	DAN IULIAN	CurteadeApelCONSTANTA
PETROVICI	MARINELA -DANIELA	CurteadeApelCONSTANTA
PINTEA	ADRIANA MIHAELA	CurteadeApelCONSTANTA
POPOACĂ	MIHAELA	CurteadeApelCONSTANTA
POPPA 	RAMONA ELENA	CurteadeApelCONSTANTA
PULBERE	GEORGIANA	CurteadeApelCONSTANTA
RĂPEANU	CLAUDIU IULIAN	CurteadeApelCONSTANTA
SÎRBU	KAMELIA	CurteadeApelCONSTANTA
STANCIU	NICOLAE	CurteadeApelCONSTANTA
TASE	VANGHELITA	CurteadeApelCONSTANTA
UZUNĂ	MARIA	CurteadeApelCONSTANTA
ZALMAN	JELENA- SORINA	CurteadeApelCONSTANTA
APZAIT	NERMIN	TribunalulCONSTANTA
ARDELEANU	ANTOANETA	TribunalulCONSTANTA
ARTENE	CORINA-SUZANA	TribunalulCONSTANTA
BACU	ROXANA NICOLETA	TribunalulCONSTANTA
BELECCIU	CRISTINA	TribunalulCONSTANTA
BOBOC	VALENTINA	TribunalulCONSTANTA
BOURCEANU	LEONARD IUSTIN	TribunalulCONSTANTA
CALIN	DANIELA	TribunalulCONSTANTA
CARAPCEA	MIRELA	TribunalulCONSTANTA
CĂRBUNE - COSAC	VASILE	TribunalulCONSTANTA
CĂRBUNE- COSAC	IULIA GAROFITA	TribunalulCONSTANTA
CASIAN	IULIA	TribunalulCONSTANTA
CIUCĂ	CAMELIA ELENA	TribunalulCONSTANTA
COADĂ	AURORA	TribunalulCONSTANTA
COMSA	DUMITRU-RADU	TribunalulCONSTANTA
CONSTANTINESCU	CRISTINA	TribunalulCONSTANTA
CRIHANĂ	ELISABETA	TribunalulCONSTANTA
DAN	LUMINITA-  MARINELA	TribunalulCONSTANTA
DAMIAN	OANA	TribunalulCONSTANTA
DUMITRA	CORNELIA	TribunalulCONSTANTA
DUTĂ	CRISTINA RAMONA	TribunalulCONSTANTA
ENACHE	CHIRATICA	TribunalulCONSTANTA
FAUR	IONELA – DIANA	TribunalulCONSTANTA
GANERA	EMILIA	TribunalulCONSTANTA
GHEORGHE 	VIOREL TEODOR	TribunalulCONSTANTA
GHERNAJA	GETA - CRISTINA	TribunalulCONSTANTA
IVAN	FELICIA MIRELA	TribunalulCONSTANTA
JIANU	CORINA-EUGENIA	TribunalulCONSTANTA
LEPADATU	ADRIANA	TribunalulCONSTANTA
LICA	LUCIAN	TribunalulCONSTANTA
MARCU	FELICIA	TribunalulCONSTANTA
MARIS	BEATRICE	TribunalulCONSTANTA
MIRICĂ	MELENTINA-NICOLETA	TribunalulCONSTANTA
MITAN	MARINELA	TribunalulCONSTANTA
MOCANU	MIHAELA CRISTINA	TribunalulCONSTANTA
MOTOC	LOREDANA VIOLETA	TribunalulCONSTANTA
NEACŞU	CĂTĂLINA	TribunalulCONSTANTA
NEAGU	ADRIAN	TribunalulCONSTANTA
NISTOR	AUGUSTINA LIVIA	TribunalulCONSTANTA
NIŢĂ	ANCA JEANINA	TribunalulCONSTANTA
OPARIUC - DAN	IULIA - LAURA	TribunalulCONSTANTA
OPREA	ADRIAN	TribunalulCONSTANTA
PASCU	SANDA IOANA	TribunalulCONSTANTA
POPESCU	CRINA MIHAELA	TribunalulCONSTANTA
RADU	IULIANA	TribunalulCONSTANTA
SPÎNOCHE	RAMONA IZABELA	TribunalulCONSTANTA
STAICU	ANIELA ADRIANA	TribunalulCONSTANTA
STĂNESCU SAS	MIHAIL	TribunalulCONSTANTA
SULIMAN	ELENA LAURA	TribunalulCONSTANTA
STOIANOGLO	ANDREEA BIANCA	TribunalulCONSTANTA
SUCIU	IULIA-CEZARA	TribunalulCONSTANTA
TĂNASE	MONICA LAURA	TribunalulCONSTANTA
TRIFANOV	CAMELIA	TribunalulCONSTANTA
TUDOR	VERONICA	TribunalulCONSTANTA
TUDORAN	IULIANA	TribunalulCONSTANTA
VLASCEANU	MIHAELA OLIMPIA	TribunalulCONSTANTA
AILENA	ANCUŢA	JudecatoriaCONSTANTA
AMZU	DORINA – EUGENIA	JudecatoriaCONSTANTA
ARHIP	ALEXANDRU - BOGDAN	JudecatoriaCONSTANTA
ARSENI	ALINA MARIA	JudecatoriaCONSTANTA
BARAC	CONSTANŢA IULIA	JudecatoriaCONSTANTA
BECHIR	MERAL	JudecatoriaCONSTANTA
BODEAN	CLAUDIA	JudecatoriaCONSTANTA
BOJIN	CLAUDIA IONELA	JudecatoriaCONSTANTA
BREŞUG	DENISSA - TINONIA	JudecatoriaCONSTANTA
BURLACU	ROBERT CRISTIAN	JudecatoriaCONSTANTA
BURTESCU 	ALEXANDRU IONUŢ	JudecatoriaCONSTANTA
CIRCIUMARU	MIHAELA-LAVINIA	JudecatoriaCONSTANTA
DAVIDENCU ŞERBAN	RĂZVAN VLADIMIR	JudecatoriaCONSTANTA
DARI	BOGDAN ALEXANDRU	JudecatoriaCONSTANTA
DOICESCU	ROXANA ELENA	JudecatoriaCONSTANTA
DUMA	ROXANA MIHAELA	JudecatoriaCONSTANTA
DUMITRU	DOINA	JudecatoriaCONSTANTA
DUŢĂ	CARMEN	JudecatoriaCONSTANTA
FĂTU	LUCIANA	JudecatoriaCONSTANTA
GÂRLICI	ELENA	JudecatoriaCONSTANTA
GHERASIM	DELIA	JudecatoriaCONSTANTA
GRĂDINARIU	MIHAELA CRISTINA	JudecatoriaCONSTANTA
GREJDEANU	AURELIA IRINA	JudecatoriaCONSTANTA
ILIE	CONSTANŢA	JudecatoriaCONSTANTA
JURUBIŢĂ	ALINA GABRIELA	JudecatoriaCONSTANTA
LEFTER	ALINA  - MARIANA	JudecatoriaCONSTANTA
LUNGU 	CRISTIAN	JudecatoriaCONSTANTA
LUPU	RALUCA ELENA	JudecatoriaCONSTANTA
MARIN	ALINA ELENA	JudecatoriaCONSTANTA
MESROBIAN	IULIANA LOREDANA	JudecatoriaCONSTANTA
MIHAI	VALENTIN	JudecatoriaCONSTANTA
MINAEV	IULIAN	JudecatoriaCONSTANTA
MIRCIOI 	MARILENA VICTORIA	JudecatoriaCONSTANTA
MOŢÎRLICHIE	LUMINIŢA SIMONA	JudecatoriaCONSTANTA
MUSTAŢĂ	GABRIEL	JudecatoriaCONSTANTA
NASTASIA	MARIUS CRISTIAN	JudecatoriaCONSTANTA
NEMETH	FRANCISC	JudecatoriaCONSTANTA
OSTACHE	IULIANA	JudecatoriaCONSTANTA
PECHEANU	LAURA IOANA	JudecatoriaCONSTANTA
PÎRLOGEA	ŞTEFANIA	JudecatoriaCONSTANTA
PREDUŢ	DORIN GEORGE	JudecatoriaCONSTANTA
RADU	CRISTINA	JudecatoriaCONSTANTA
RIZEA	MIHAELA MONICA	JudecatoriaCONSTANTA
SECURE	EMILIA	JudecatoriaCONSTANTA
SINCU – BADEA	ADRIANA – IOANA	JudecatoriaCONSTANTA
SOFICA	ANA MARIA	JudecatoriaCONSTANTA
SORESCU	OANA MIHAELA	JudecatoriaCONSTANTA
STANCIU	MIHAELA IONELA	JudecatoriaCONSTANTA
ŞTEFAN (NICOLAE)	CARMEN MĂDĂLINA	JudecatoriaCONSTANTA
TICEA	VALENTIN	JudecatoriaCONSTANTA
TIMOAŞCĂ	MARIA	JudecatoriaCONSTANTA
TRÎNTU	MĂDĂLINA	JudecatoriaCONSTANTA
TURCU	CONSTANTINA MONICA	JudecatoriaCONSTANTA
ULIANOV	ANGELICA	JudecatoriaCONSTANTA
VASILE	ADRIANA	JudecatoriaCONSTANTA
VĂDUVA	VICTOR	JudecatoriaCONSTANTA
ZAHARIA	MIRELA RAMONA	JudecatoriaCONSTANTA
DEHENEA	CONSTANTIN	JudecatoriaMEDGIDIA
ISUF	DANIELA GEORGETA	JudecatoriaMEDGIDIA
IVAN	DANIELA	JudecatoriaMEDGIDIA
MĂSTACAN	ERICH-EMILIAN	JudecatoriaMEDGIDIA
OLTEANU	ELENA	JudecatoriaMEDGIDIA
OVAC	IOAN OCTAVIAN	JudecatoriaMEDGIDIA
RIZA	LIVIA CONSTANŢA	JudecatoriaMEDGIDIA
SLATE	AIDA IOLANDA	JudecatoriaMEDGIDIA
STĂNESCU	ISABELA ALINA	JudecatoriaMEDGIDIA
STĂNILĂ	FĂNEL	JudecatoriaMEDGIDIA
TELESCU	DANIELA MIHAELA	JudecatoriaMEDGIDIA
UNGUREANU	VIRGIL MARIUS	JudecatoriaMEDGIDIA
VAMVU	ANGELICA VALI	JudecatoriaMEDGIDIA
BĂDESCU	CORNELIU MARIUS	JudecatoriaMANGALIA
BEREVOESCU	CARMEN CLAUDIA	JudecatoriaMANGALIA
DAVID	ANTON-CRISTIAN	JudecatoriaMANGALIA
DRENTEA	LENUŢA	JudecatoriaMANGALIA
ENE	ALIN VASILE	JudecatoriaMANGALIA
IANCU	STELIANA GABRIELA	JudecatoriaMANGALIA
JALBĂ	LUCIAN	JudecatoriaMANGALIA
LAZĂR	DANIELA LILIANA	JudecatoriaMANGALIA
TOADER	DORU - CATALIN	JudecatoriaMANGALIA
PELELUNGĂ	MARIANA	JudecatoriaHARSOVA
SZILAGYI	RALUCA MEDA	JudecatoriaHARSOVA
ANDRECENCU	VALERIA	TribunalulTULCEA
ANDREI	CARMEN DANIELA	TribunalulTULCEA
ANDREI	IORDAN	TribunalulTULCEA
BIBU	ELENA	TribunalulTULCEA
MOCANU	VASILICA	TribunalulTULCEA
NEACSU	ELENA	TribunalulTULCEA
NICHIFOR	DOINA	TribunalulTULCEA
NICOLA GHEORGHIU	DANIEL	TribunalulTULCEA
NICULACHE	LUMINIŢA	TribunalulTULCEA
PESCĂRUS	MARINELA	TribunalulTULCEA
PISICĂ	LUMINITA DIANA	TribunalulTULCEA
ROIBU	STEFANIA	TribunalulTULCEA
ŞURCULESCU	MĂDĂLINA LELIA	TribunalulTULCEA
VITOS	RAZVAN - ARCADIU	TribunalulTULCEA
ANUŢI	STELIAN	JudecatoriaTULCEA
CIOFU	VLAD	JudecatoriaTULCEA
GĂVAN	LILIANA MARIA	JudecatoriaTULCEA
GHEORGHE	SIMONA	JudecatoriaTULCEA
HANZU	IOAN	JudecatoriaTULCEA
IONIŢĂ	VERONICA	JudecatoriaTULCEA
MATEI	CATALIN - MARIAN	JudecatoriaTULCEA
NEACŞU	GABRIEL	JudecatoriaTULCEA
NEDELCU	NICOLAE	JudecatoriaTULCEA
STOIAN	IZABELA	JudecatoriaTULCEA
ŞURCULESCU	FLORIN	JudecatoriaTULCEA
ALEXE	AURICA	JudecatoriaBABADAG
CRASOVSCHI	ALINA	JudecatoriaBABADAG
STEFĂNESCU-LUNCA	ELENA IVONA	JudecatoriaBABADAG
ANDRESCU	ALINA	JudecatoriaMACIN
DOMNITEANU	ADRIAN	JudecatoriaMACIN
GIOL	MONICA FLORENTINA	JudecatoriaMACIN
ALBU	ADELA IULIANA	CurteadeApelCRAIOVA
BALACI	LIANA	CurteadeApelCRAIOVA
BĂDULESCU	ŞTEFANA	CurteadeApelCRAIOVA
BĂLTEANU	EMILIA	CurteadeApelCRAIOVA
BARBU	LAVINIA GABRIELA	CurteadeApelCRAIOVA
BELULESCU	PARASCHIVA	CurteadeApelCRAIOVA
BERCEANU	MANUELA CRISTINA	CurteadeApelCRAIOVA
BUNEA	LUCIAN	CurteadeApelCRAIOVA
BUNOIU	CARMEN TAMARA	CurteadeApelCRAIOVA
CADEA	STELIAN AURELIAN	CurteadeApelCRAIOVA
CALOTĂ-PONEA	ADINA- GEORGETA	CurteadeApelCRAIOVA
CARNELUTI	GABRIELA MARIANA	CurteadeApelCRAIOVA
CERCEL	ANAMARIA CRISTINA	CurteadeApelCRAIOVA
CHIMOIU	LAURA MARIANA	CurteadeApelCRAIOVA
CIOBANU	GEORGE	CurteadeApelCRAIOVA
CIOLOFAN	ALINA	CurteadeApelCRAIOVA
CIUREZU GHERGHE	MIRELA CARMEN	CurteadeApelCRAIOVA
COJOCARU	FLORENŢA CARMEN	CurteadeApelCRAIOVA
COMĂNESCU	GABRIEL DĂNUŢ	CurteadeApelCRAIOVA
CONDURAT	EMANOIL ROBERT	CurteadeApelCRAIOVA
COTORA	MIHAELA- ELISABETA	CurteadeApelCRAIOVA
COVEI	MARIN	CurteadeApelCRAIOVA
CRĂCIUNOIU	SIMONA CRISTINA	CurteadeApelCRAIOVA
DIACONESCU	FLORICA	CurteadeApelCRAIOVA
DRĂGUŢ	NELA	CurteadeApelCRAIOVA
DUMITRU	ONIŢA	CurteadeApelCRAIOVA
DUMITRU	ANDREEA MONA	CurteadeApelCRAIOVA
DUNĂ	LILIANA MĂDĂLINA	CurteadeApelCRAIOVA
ENĂŞOIU	IRINA	CurteadeApelCRAIOVA
EPURE	LIGIA	CurteadeApelCRAIOVA
FĂNUŢĂ	MARIA MAGDALENA	CurteadeApelCRAIOVA
FILIMON	DORU	CurteadeApelCRAIOVA
GHERGHINA	CLAUDIU ANGELO	CurteadeApelCRAIOVA
GHERGHINĂ	LOTUS MANUELA	CurteadeApelCRAIOVA
GHIŢĂ	OANA CATALINA	CurteadeApelCRAIOVA
GORGĂNEANU	CORNELIA NICOLETA	CurteadeApelCRAIOVA
ILIE	CARMEN	CurteadeApelCRAIOVA
ILIE	GHEORGHE AUREL	CurteadeApelCRAIOVA
IONESCU	GABRIELA	CurteadeApelCRAIOVA
IRIZA	CONSTANTIN	CurteadeApelCRAIOVA
LĂLOIANU	LUCIA MARIANA	CurteadeApelCRAIOVA
LĂUTARU	AURORA CLAUDIA LAVINIA	CurteadeApelCRAIOVA
LUNGU	MARIAN	CurteadeApelCRAIOVA
LUNGU	SANDA ELENA	CurteadeApelCRAIOVA
LUPEA	DOINA	CurteadeApelCRAIOVA
MARICA	ALEXANDRINA	CurteadeApelCRAIOVA
MATEUCĂ	RADU CRISTIAN	CurteadeApelCRAIOVA
MIREA	VALERICA	CurteadeApelCRAIOVA
MIREA	TATIANA	CurteadeApelCRAIOVA
MEREANU	CONSTANTIN	CurteadeApelCRAIOVA
MIHAI ZAMFIR	LUCIAN CĂTĂLIN	CurteadeApelCRAIOVA
MITRACHE	ANDREI COSMIN	CurteadeApelCRAIOVA
MITRACHE 	ROXANA	CurteadeApelCRAIOVA
MITRANCA	MIHAELA	CurteadeApelCRAIOVA
MITRU	AUGUSTINA CARMINA	CurteadeApelCRAIOVA
MOLEANU	ECATERINA	CurteadeApelCRAIOVA
MOŢ	SOFIA-MARIANA	CurteadeApelCRAIOVA
MOŢĂTĂIANU	IOANA	CurteadeApelCRAIOVA
MOTIRLICHIE	COSTINEL	CurteadeApelCRAIOVA
MUDAVA	MARIANA	CurteadeApelCRAIOVA
NICOLAU- ALEXANDROIU	MIHAELA LOREDANA	CurteadeApelCRAIOVA
OCHEA	NELA IULIANA	CurteadeApelCRAIOVA
PANDURU	MARIN	CurteadeApelCRAIOVA
PASCU	MARIANA	CurteadeApelCRAIOVA
PASCU	SORIN	CurteadeApelCRAIOVA
PAUN	PAULA	CurteadeApelCRAIOVA
PETRIA MITRAN	SORINA LUCIA	CurteadeApelCRAIOVA
PLUGĂRESCU	MARIUS EMANUEL	CurteadeApelCRAIOVA
POPESCU	CARMEN ELENA	CurteadeApelCRAIOVA
POPESCU	CONSTANTIN	CurteadeApelCRAIOVA
POPESCU 	SIMONA	CurteadeApelCRAIOVA
PREDA – POPESCU	MANUELA PAULA	CurteadeApelCRAIOVA
RADULESCU	TATIANA	CurteadeApelCRAIOVA
RĂDULESCU	ANGELA	CurteadeApelCRAIOVA
RĂESCU	MARIANA ALINA	CurteadeApelCRAIOVA
RAICEA	CRISTINA	CurteadeApelCRAIOVA
SALAN	COSTINELA	CurteadeApelCRAIOVA
SAMIL	AURORA IONELA	CurteadeApelCRAIOVA
ŞELEA	MIRCEA MUGUREL	CurteadeApelCRAIOVA
ŞELEA	SANDA CAMELIA	CurteadeApelCRAIOVA
SPÂNU	DAN  ŞTEFAN	CurteadeApelCRAIOVA
SPIRIDON	ANA MARIA DANA	CurteadeApelCRAIOVA
STAN	ELENA	CurteadeApelCRAIOVA
ŢĂNDĂREANU	NICOLETA	CurteadeApelCRAIOVA
ŢAPURIN	TANIA	CurteadeApelCRAIOVA
TOMESCU	MARIOARA CARMEN	CurteadeApelCRAIOVA
TRIFĂNESCU	VALENTINA	CurteadeApelCRAIOVA
ŢÂRLEA	MIRELA-CRISTINA	CurteadeApelCRAIOVA
VIJLOI 	DANIELA	CurteadeApelCRAIOVA
VÎLCULESCU	IONELA	CurteadeApelCRAIOVA
VIZIRU	GABRIEL	CurteadeApelCRAIOVA
ALEXANDRU	LILIANA	TribunalulDOLJ
ALEXANDROIU	GABRIELA	TribunalulDOLJ
ANGHELINA	OLTEA PAULA	TribunalulDOLJ
BARBU 	LUMINIŢA LARISA	TribunalulDOLJ
CAIMAC	MARIA ADRIANA	TribunalulDOLJ
CIONTU	ALINA GABRIELA	TribunalulDOLJ
COJOCARU BICHEA	CARMEN CAMELIA	TribunalulDOLJ
COLCEAG	CRISTINA IZABELA	TribunalulDOLJ
COLŢAN	LOREDANA CRISTIANA	TribunalulDOLJ
COMĂNESCU	CRISTINA MANUELA	TribunalulDOLJ
CROITORIU	CĂTĂLINA GENUA	TribunalulDOLJ
DIACONESCU	MARIUS   BOGDAN	TribunalulDOLJ
DIJMĂRESCU 	ION COSMIN	TribunalulDOLJ
DINCULESCU	RALUCA ELENA	TribunalulDOLJ
DINU	CLAUDIA	TribunalulDOLJ
DRAGOMIR 	LILIANA	TribunalulDOLJ
FILIMON	GABRIELA	TribunalulDOLJ
FIRU	MARGA	TribunalulDOLJ
FLOREA	ELVIS	TribunalulDOLJ
GASPAR	RODICA STELUŢA	TribunalulDOLJ
GAVRILA	MARIANA ELENA	TribunalulDOLJ
GEORCOTINĂ	MARIOARA	TribunalulDOLJ
GHERVASE	DENIS GABRIELA	TribunalulDOLJ
GHIŢĂ	ADINA ELVIRA	TribunalulDOLJ
GRECESCU	CRISTIAN MARIUS	TribunalulDOLJ
GRECU	DORIN LUCIAN	TribunalulDOLJ
GRIGORAŞCU	SIMONA DANIELA	TribunalulDOLJ
HARTMANN	MARIA ROXANA	TribunalulDOLJ
HARTMANN	TIBERIU IOAN	TribunalulDOLJ
ILEANA – NIŢĂ	VALI ŞTEANIA	TribunalulDOLJ
ILIE	MELANIA	TribunalulDOLJ
ILIESCU	CARMEN ELENA	TribunalulDOLJ
IVĂNUŞ	MONICA DANIELA	TribunalulDOLJ
MACAMETE	ELENA CAMELIA	TribunalulDOLJ
MARINESCU	SIMONA-LUCIA	TribunalulDOLJ
MARINESCU	ALINA MIHAELA	TribunalulDOLJ
MARINESCU	ALINA MARIANA	TribunalulDOLJ
MARUSCIAC	LELIA	TribunalulDOLJ
MELEACĂ	ELENA MIRTHA	TribunalulDOLJ
MISCHIANU	ALINA - GABRIELA	TribunalulDOLJ
NEDELCU	MANUELA	TribunalulDOLJ
NEGOIŢĂ	MIRELA ELENA	TribunalulDOLJ
NICOLA	MARIA	TribunalulDOLJ
NICU	MIRCEA	TribunalulDOLJ
OPREA	MARIN	TribunalulDOLJ
OSICEANU	IONICA	TribunalulDOLJ
OTOVESCU	DANIEL	TribunalulDOLJ
PĂTRU	ALINA	TribunalulDOLJ
PETCU	GABRIELA	TribunalulDOLJ
POPA	VIORICA	TribunalulDOLJ
POPESCU	IONELA GABRIELA	TribunalulDOLJ
PREOTEASA	CARMEN DANIELA	TribunalulDOLJ
ROTARU	CARMEN	TribunalulDOLJ
SANDU	ECATERINA	TribunalulDOLJ
SCUMPIERIU	ALINA-MARIANA	TribunalulDOLJ
SCURTU 	JANA	TribunalulDOLJ
SIMION	GABRIELA	TribunalulDOLJ
SPIRIDON	DOINA LILIANA	TribunalulDOLJ
STANCU	DANIEL FĂNEL	TribunalulDOLJ
STĂNILĂ - DAN	VERGINICA	TribunalulDOLJ
STOICULESCU	NATALIA	TribunalulDOLJ
TIUGAN	VERONICA	TribunalulDOLJ
TUDOR OLTEANU	CRISTINA	TribunalulDOLJ
ŢĂRUŞ	ALINA MANUEMA	TribunalulDOLJ
UDREA	LUMINITA LAURA	TribunalulDOLJ
UNCHEAŞU	CECILIA	TribunalulDOLJ
VĂRZARU	EUGENIA	TribunalulDOLJ
VASILE	VALENTINA	TribunalulDOLJ
VASILESCU	GABRIELA - AURELIA	TribunalulDOLJ
VIŞAN	ILIE SILVIU	TribunalulDOLJ
VÂRTOPEANU	MARIANA CRISTINA	TribunalulDOLJ
ZGLIMBEA	LIANA RAMONA	TribunalulDOLJ
ANCUŢA	GEORGETA RALUCA	JudecatoriaCRAIOVA
BĂRBUŢI	ADELA ILEANA	JudecatoriaCRAIOVA
BĂRBULEŢ	LUIZA - DIANA	JudecatoriaCRAIOVA
BÎRDĂU	GHEORGHE	JudecatoriaCRAIOVA
BIRĂU	CRISTINA GABRIELA	JudecatoriaCRAIOVA
BIVOLARU	MARILENA SIMONA	JudecatoriaCRAIOVA
BONTEA	RALUCA OANA	JudecatoriaCRAIOVA
BRAN	CĂTĂLINA MARIA	JudecatoriaCRAIOVA
BUSUIOC	SIMONA	JudecatoriaCRAIOVA
CAIAN	CORNEL GABRIEL	JudecatoriaCRAIOVA
CANACHE	LILIEA	JudecatoriaCRAIOVA
CARAMALIU	CAMELIA	JudecatoriaCRAIOVA
CIORA	GABRIELA CRISTINA	JudecatoriaCRAIOVA
CIUCĂ	TATIANA GEORGETA	JudecatoriaCRAIOVA
CÎRLOGEA	ANGELICA	JudecatoriaCRAIOVA
CRĂCIUN	ANDREEA	JudecatoriaCRAIOVA
CRÎNGUŞ	ROMULUS DAN	JudecatoriaCRAIOVA
DANA	CORINA	JudecatoriaCRAIOVA
DINU	GIGI	JudecatoriaCRAIOVA
DOBRIN	RODICA MIHAELA	JudecatoriaCRAIOVA
DRĂGOI	CORINA FLORENTINA	JudecatoriaCRAIOVA
DUDU	FLORICA	JudecatoriaCRAIOVA
FIRAN 	VERONICA VIOLETA	JudecatoriaCRAIOVA
FLORESCU	VIOLETA	JudecatoriaCRAIOVA
GHEALDIR	ANISOARA	JudecatoriaCRAIOVA
GRECU	FLORIN MARIUS	JudecatoriaCRAIOVA
GUŢESCU	NICOLETA VIORICA	JudecatoriaCRAIOVA
IANOŞI 	MIRELA	JudecatoriaCRAIOVA
LILEA	VALENTIN - CRISTIAN	JudecatoriaCRAIOVA
MARIN	MIHAI	JudecatoriaCRAIOVA
MARINAŞ	SORINA IOLANDA	JudecatoriaCRAIOVA
MĂRIUŢĂ	CLAUDIA CARMEN	JudecatoriaCRAIOVA
MECLENEANU	MARIANA DANIELA	JudecatoriaCRAIOVA
MINCĂ	MARCELA	JudecatoriaCRAIOVA
MOŢA	SIMONA - CRISTINA	JudecatoriaCRAIOVA
MUNCIOIU	CRISTINA	JudecatoriaCRAIOVA
NEDELCEA	LAURA	JudecatoriaCRAIOVA
PĂTRA	COSMIN-CLAUDIU	JudecatoriaCRAIOVA
POPA	CRISTIAN- DANIEL	JudecatoriaCRAIOVA
PUTERE	LEONTINA	JudecatoriaCRAIOVA
RADU	CLAUDIA MIRELA	JudecatoriaCRAIOVA
ŞERBAN	RĂSVAN GABRIEL	JudecatoriaCRAIOVA
SORBALĂ	RUSLANA	JudecatoriaCRAIOVA
SPIRIDONESCU 	IOANA - NICOLETA	JudecatoriaCRAIOVA
STROE	DOMNICA	JudecatoriaCRAIOVA
TĂLPĂŞANU	LAVINIA	JudecatoriaCRAIOVA
TROACĂ	RODICA MIHAELA	JudecatoriaCRAIOVA
UNCHEAŞU	DUMITRU	JudecatoriaCRAIOVA
UNCHEŞELU	MARCELA ALINA	JudecatoriaCRAIOVA
VELICOVICI	ALIS-MARIA	JudecatoriaCRAIOVA
VÎRLAN	VALERIA	JudecatoriaCRAIOVA
VOINEA	MIRELA	JudecatoriaCRAIOVA
ZGLIMBEA	ANA - ISABELA	JudecatoriaCRAIOVA
ZORILĂ	ELENA	JudecatoriaCRAIOVA
BELU	FLOAREA	JudecatoriaBAILESTI
CAIMAC	PETRIŞOR	JudecatoriaBAILESTI
GIOROCEANU	ALINA MIHAELA	JudecatoriaBAILESTI
GREGORIAN	ALEXANDRA	JudecatoriaBAILESTI
PÎRVU	MIRCEA	JudecatoriaBAILESTI
POENARU	VALENTINA	JudecatoriaBAILESTI
ŞERBAN	MARIAN	JudecatoriaBAILESTI
GOSA	CONSTANTIN CĂTĂLIN	JudecatoriaFILIASI
OŢEL	SIMONA	JudecatoriaFILIASI
STOIAN	ELENA DANIELA	JudecatoriaFILIASI
DAŞU	GHEORGHE	JudecatoriaSEGARCEA
OŢEL	DANIEL	JudecatoriaSEGARCEA
POPA	LIVIA MARILENA	JudecatoriaSEGARCEA
ZĂVĂLAŞI	DOINA GABRIELA	JudecatoriaSEGARCEA
BĂDULESCU	AURELIAN GABRIEL	JudecatoriaCALAFAT
MARIN	COSMIN NICUŞOR	JudecatoriaCALAFAT
MUNGIU	ELENA	JudecatoriaCALAFAT
POPESCU	MIOARA	JudecatoriaCALAFAT
STOENESCU	DORINA	JudecatoriaCALAFAT
BĂDESCU	CAMELIA	TribunalulGORJ
BĂDIŢA	NICOLETA	TribunalulGORJ
BĂNICĂ	VALENTIN	TribunalulGORJ
BECHERU	MARIANA	TribunalulGORJ
BELU	AMALIA	TribunalulGORJ
BERCULESCU	LUMINIŢA	TribunalulGORJ
BONCU	TEOFIL	TribunalulGORJ
BUDAN	CARMEN NICOLETA	TribunalulGORJ
CĂPITĂNESCU	SORINA NICOLETA	TribunalulGORJ
CELEA	CRISTINA	TribunalulGORJ
CÎLNICEANU	MARIA ANGELA	TribunalulGORJ
CÎRSTESCU	DAMIAN	TribunalulGORJ
CONSTANTINESCU	GHEORGHE	TribunalulGORJ
DOGARU	GEANINA	TribunalulGORJ
EFTENOIU	GHEORGHITA	TribunalulGORJ
ENCESCU	FLORIN	TribunalulGORJ
GĂRCU	GHEORGHE	TribunalulGORJ
GHEJU	ELENA	TribunalulGORJ
GRAMA	MARIANA	TribunalulGORJ
IONESCU	REMUS GHEORGHE	TribunalulGORJ
LUNGANOIU	MADALINA ELENA	TribunalulGORJ
MANŢOG	ECATERINA LUMINITA	TribunalulGORJ
MARIN	ION	TribunalulGORJ
MORIE	CARINA ANDA	TribunalulGORJ
MOŢA	TINELA	TribunalulGORJ
NEGRULESCU	VERONICA	TribunalulGORJ
NICOLESCU	ALIN SORIN	TribunalulGORJ
PĂSĂRIN	DUMITRU	TribunalulGORJ
PENA 	EMILIA CRISTINA	TribunalulGORJ
POPESCU	TOMA	TribunalulGORJ
RADU	GHEORGHE	TribunalulGORJ
RĂDOI	MARIA LUMINIŢA	TribunalulGORJ
SARCINĂ	LAURA MIHAELA	TribunalulGORJ
SEMENESCU	OCTAVIAN COSMIN	TribunalulGORJ
SIMION	MIRELA CLAUDIA	TribunalulGORJ
STAICU	ANGELA SIMINA	TribunalulGORJ
SURDOIU	MIHAELA	TribunalulGORJ
STĂNULESCU	ION	TribunalulGORJ
STEGARU	ANCA ELENA	TribunalulGORJ
SURDOIU	DANIEL	TribunalulGORJ
ŞARAPATIN	ŞERBAN	TribunalulGORJ
ŞUVAGĂU	NICOLIŢA	TribunalulGORJ
TALIANU	MARIOARA	TribunalulGORJ
TĂTĂROIU	SIMONA IOANA	TribunalulGORJ
TÎLVESCU	ANTOANETA-LOTICA	TribunalulGORJ
TOMESCU	LUCIA	TribunalulGORJ
TUDOSE	FLORENTINA   DOINA	TribunalulGORJ
UDROIU	NICULINA	TribunalulGORJ
ULMET	STELIAN   VICTOR	TribunalulGORJ
VĂTAVU	MARIA	TribunalulGORJ
VLĂDUCU	MARINELA CORNELIA	TribunalulGORJ
BOLOVAN	DANIELA	JudecatoriaTARGUJIU
BOIAN	LIVIU	JudecatoriaTARGUJIU
BUCICĂ	ANISOARA	JudecatoriaTARGUJIU
CAMBREA	IRINA MARILENA	JudecatoriaTARGUJIU
CATRINOIU	PARASCHIVA	JudecatoriaTARGUJIU
CORNESCU	DANIEL	JudecatoriaTARGUJIU
CRUCERU 	LILIANA MARIA	JudecatoriaTARGUJIU
DOGARU	MIHAI	JudecatoriaTARGUJIU
DUTESCU	PANTELIMON	JudecatoriaTARGUJIU
IVĂNIŞI	DORINA	JudecatoriaTARGUJIU
JIANU	ADINA-DANA	JudecatoriaTARGUJIU
LUPULESCU	CONSTANTIN PETRISOR	JudecatoriaTARGUJIU
MĂNESCU	CARMEN LOREDANA	JudecatoriaTARGUJIU
MĂRGULESCU	EMIL-CLAUDIU	JudecatoriaTARGUJIU
MERISESCU	MIHAI	JudecatoriaTARGUJIU
NANU	IONELA LUISA	JudecatoriaTARGUJIU
NICOLCESCU	ANA MARIA	JudecatoriaTARGUJIU
NIŢU	NICOLETA	JudecatoriaTARGUJIU
OPROIU	LAVINIA -MIHAELA	JudecatoriaTARGUJIU
PĂCURARU	MIHAELA	JudecatoriaTARGUJIU
PĂTRULESCU	SORIN	JudecatoriaTARGUJIU
POPESCU	JANETA	JudecatoriaTARGUJIU
POPESCU	OTILIA CESARINA	JudecatoriaTARGUJIU
POPESCU	ELENA	JudecatoriaTARGUJIU
POPESCU	ALEXANDRU BOGDAN	JudecatoriaTARGUJIU
POPESCU-BEJAT	LUCIAN	JudecatoriaTARGUJIU
PREDA	RALUCA ELENA	JudecatoriaTARGUJIU
PUIANU	MINODORA	JudecatoriaTARGUJIU
RETEZANU	ALINA-MIHAELA	JudecatoriaTARGUJIU
STAICU	ANGELA SIMINA	JudecatoriaTARGUJIU
STEGĂROIU	ELENA GABRIELA	JudecatoriaTARGUJIU
STOIAN	MIRELA-ALEXANDRA	JudecatoriaTARGUJIU
STOIAN	EMILIA MIHAELA	JudecatoriaTARGUJIU
TABACU	ANGELA ELENA	JudecatoriaTARGUJIU
TITERLEA	ANDREIA DANIELA	JudecatoriaTARGUJIU
TUFAN	RAMONA BIANCA	JudecatoriaTARGUJIU
ANDREI	ANTONELA MARILENA	JudecatoriaTARGUCARBUNESTI
FĂRCĂŞANU	CRISTINA	JudecatoriaTARGUCARBUNESTI
MĂLĂESCU	IOANA RUXANDRA	JudecatoriaTARGUCARBUNESTI
MERIŞESCU	MIHAELA-CARMEN	JudecatoriaTARGUCARBUNESTI
PĂIUŞ	STELIAN	JudecatoriaTARGUCARBUNESTI
POPESCU	NICOLETA MIHAELA	JudecatoriaTARGUCARBUNESTI
PULBERE	LAURA MIHAELA	JudecatoriaTARGUCARBUNESTI
ROGOJEANU	MARIA	JudecatoriaTARGUCARBUNESTI
VĂTAFU	CARMEN	JudecatoriaTARGUCARBUNESTI
COSTAICHE	TOMA PAUL	JudecatoriaNOVACI
DAFINESCU	ELENA	JudecatoriaNOVACI
FLOREA	RADU MIHAI	JudecatoriaNOVACI
ALDULESCU	ŞTEFAN	JudecatoriaMOTRU
BĂDOIU	DANIELA-CARMEN	JudecatoriaMOTRU
BĂDOIU	VASILE	JudecatoriaMOTRU
IACOB	CONSTANTIN	JudecatoriaMOTRU
OLARU	PETRE DORIN	JudecatoriaMOTRU
SECOTĂ	IULIANA GEORGIANA	JudecatoriaMOTRU
TUDORESCU	MARIA MIHAELA	JudecatoriaMOTRU
VASILE	EUGENIA ŞTEFANIA	JudecatoriaMOTRU
ACSINTE	MIHAI	TribunalulMEHEDINTI
BĂRBĂNŢAN	LUCIA CODRUTA	TribunalulMEHEDINTI
BARBU	ADELA	TribunalulMEHEDINTI
BARBULESCU	ADI	TribunalulMEHEDINTI
BEJINARU	FLORICA	TribunalulMEHEDINTI
BIRAU	MONICA	TribunalulMEHEDINTI
BORDEA	MAGDALENA-LUCIA	TribunalulMEHEDINTI
BRANDIBUR	CLAUDIU-TAVI	TribunalulMEHEDINTI
BURTEA (IANCU)	CRISTINA	TribunalulMEHEDINTI
CIOCLOV	CRISTIAN EUGEN	TribunalulMEHEDINTI
CRISTEL	AMALIA CECILIA	TribunalulMEHEDINTI
DINU	NADIA SILVIA	TribunalulMEHEDINTI
FALCAN	CAMELIA AURORA	TribunalulMEHEDINTI
FALCAN	CLAUDIU DANIEL	TribunalulMEHEDINTI
IORDACHE	MARIANA	TribunalulMEHEDINTI
LUCA	CLARA DANIELA	TribunalulMEHEDINTI
MAZILESCU 	CRISTINA	TribunalulMEHEDINTI
MIHAI	FULGA	TribunalulMEHEDINTI
MIHĂIŢĂ	AURORA IOANA	TribunalulMEHEDINTI
MUDAVA	NARCISA MIHAELA	TribunalulMEHEDINTI
NEGREANU	VICTORIA	TribunalulMEHEDINTI
NICOLAE	MIRELA DANIELA	TribunalulMEHEDINTI
OLARU	CARMEN MIHAELA	TribunalulMEHEDINTI
ORFESCU	ARISTICA	TribunalulMEHEDINTI
POPESCU	CORNELIU BOGDAN	TribunalulMEHEDINTI
POPESCU	CORNELIU	TribunalulMEHEDINTI
POPESCU	MIHAELA	TribunalulMEHEDINTI
POPESCU	NOREL	TribunalulMEHEDINTI
POPESCU	VICTORIA CERASELA	TribunalulMEHEDINTI
ROLEA	GINA	TribunalulMEHEDINTI
ROMAN	VICTOR	TribunalulMEHEDINTI
SFINTESCU	LILIANA	TribunalulMEHEDINTI
SAVU	LAURA VICTORIA	TribunalulMEHEDINTI
SIMA	ION COSMIN	TribunalulMEHEDINTI
TAMBLAC	IONELA	TribunalulMEHEDINTI
TĂNĂSESCU	CATERINA	TribunalulMEHEDINTI
TUDOR	EUGENIA	TribunalulMEHEDINTI
ULIU	ROMICĂ GEORGE	TribunalulMEHEDINTI
ZOICAN	DORINEL	TribunalulMEHEDINTI
ZOICAN	CAMELIA	TribunalulMEHEDINTI
BALACI	ANA MARIA	JudecatoriaDROBETATURNUSEVERIN
BUSUIOC	LUMINIŢA	JudecatoriaDROBETATURNUSEVERIN
CAMENIŢĂ	DANIELA	JudecatoriaDROBETATURNUSEVERIN
CHIRIŢĂ 	DORIAN	JudecatoriaDROBETATURNUSEVERIN
CIUPITU	ELENA MARINELA	JudecatoriaDROBETATURNUSEVERIN
GHEORGHE	IOANA CRISTINA	JudecatoriaDROBETATURNUSEVERIN
GHIMPĂU	ALIN -MIHAIL	JudecatoriaDROBETATURNUSEVERIN
GONGONE	ANA RUXANDRA	JudecatoriaDROBETATURNUSEVERIN
GRIGORESCU	LILIANA	JudecatoriaDROBETATURNUSEVERIN
GURAN	DUMITRU	JudecatoriaDROBETATURNUSEVERIN
MINEA	MARICICA	JudecatoriaDROBETATURNUSEVERIN
MUDAVA	IONUŢ	JudecatoriaDROBETATURNUSEVERIN
PANTELIMON	LENUŢA TELUŢA	JudecatoriaDROBETATURNUSEVERIN
POTÂRCĂ	IONEL	JudecatoriaDROBETATURNUSEVERIN
STĂNCIOIU	ADI GABRIEL	JudecatoriaDROBETATURNUSEVERIN
TOSA	TATIANA	JudecatoriaDROBETATURNUSEVERIN
TUDOSIE	ALINA	JudecatoriaDROBETATURNUSEVERIN
UNGUREANU	MARIA GABRIELA	JudecatoriaDROBETATURNUSEVERIN
ZAHARIA	DANIEL	JudecatoriaDROBETATURNUSEVERIN
ZAHARIA	GEORGE CRISTINEL	JudecatoriaDROBETATURNUSEVERIN
ZOICAN	ALINA DANIELA	JudecatoriaDROBETATURNUSEVERIN
BUTA	OCTAVIAN	JudecatoriaSTREHAIA
DECĂ	IULIA ANDREEA	JudecatoriaSTREHAIA
FOCULESCU	CORINA ALINA	JudecatoriaSTREHAIA
GROZA	ANAMARIA	JudecatoriaSTREHAIA
NEAŢU	VIORICA ŞTEFANIA	JudecatoriaSTREHAIA
VARZARU	SORINEL	JudecatoriaSTREHAIA
BAJMATĂRĂ	CLAUDIA LEONTINA	JudecatoriaBAIADEARAMA
BAJMATĂRĂ	CONSTANTIN ION	JudecatoriaBAIADEARAMA
UNGUREANU	CORADO ADRIAN	JudecatoriaBAIADEARAMA
ARDELEANU	VLAD ANDREI	JudecatoriaORSOVA
CUNICELU	OLIMPIA ELISABETA	JudecatoriaORSOVA
CURELEA	ADRIAN	JudecatoriaORSOVA
MUNTEANU	OANA CRISTINA	JudecatoriaORSOVA
UNGUREANU	ION CRISTINEL	JudecatoriaORSOVA
BUZATU	GHEORGHE	JudecatoriaVANJUMARE
DURAC	AURELIA DORINA	JudecatoriaVANJUMARE
LUNGOCI	LAVINIA	JudecatoriaVANJUMARE
NEAGOE	ANISOARA	JudecatoriaVANJUMARE
BEŞLIU	ION	TribunalulOLT
BIOLAN	GHEORGHE	TribunalulOLT
CĂLUŞARU	CRISTINA	TribunalulOLT
COTOI 	DIANA MIHAELA	TribunalulOLT
DAN 	ILEANA	TribunalulOLT
DICU 	IULIANA	TribunalulOLT
GEORGESCU	MARINELA	TribunalulOLT
GRIGORIE	IONEL	TribunalulOLT
ISTRATE	GEORGETA	TribunalulOLT
MARINESCU	EUGENIA CARMEN	TribunalulOLT
MARUŞCĂ	GHEORGHE	TribunalulOLT
MEŞINĂ	NUŢI FLORENTINA	TribunalulOLT
MIRCESCU	IOANA	TribunalulOLT
OANNCEA	ION SILVIU	TribunalulOLT
OLTEAN	SIMONA	TribunalulOLT
OPREA	LILIANA	TribunalulOLT
PIŢU	MARIN-CONSTANTIN	TribunalulOLT
PRETORIAN	OANA MIHAELA	TribunalulOLT
SAMOILESCU	CLAUDIA	TribunalulOLT
SAVU	MIHAELA IULIANA	TribunalulOLT
SLUJITORU	TUDOREL	TribunalulOLT
SMARANDA	VALERIA	TribunalulOLT
SPRÎNCEANĂ	DANIELA	TribunalulOLT
STANA	FLORENTINA	TribunalulOLT
STÂNGĂ	EMILIA DENISA	TribunalulOLT
ŢIŢOIU	ANDREEA CORNELIA	TribunalulOLT
VASILE	SORINEL	TribunalulOLT
VLAD	MARINELA	TribunalulOLT
ZULEANU	MIHAELA GABRIELA	TribunalulOLT
ARABELEA	FĂNEL GABRIEL	JudecatoriaSLATINA
BOTEA	MARIA MIHAELA	JudecatoriaSLATINA
BUZATU	NICOLETA	JudecatoriaSLATINA
CHIRCUŞI	NICOLAE CĂTĂLIN	JudecatoriaSLATINA
CISMARU	MIHAELA - DIANA	JudecatoriaSLATINA
CONSTANTIN	LUIS	JudecatoriaSLATINA
CREŢEANU	ANA MARIA	JudecatoriaSLATINA
DICU	VIORICA MIRELA	JudecatoriaSLATINA
DUMITRESCU	PAULICĂ	JudecatoriaSLATINA
IANCU	CLAUDIA	JudecatoriaSLATINA
LIXANDRU	DAN	JudecatoriaSLATINA
LIXANDRU	ANA MARIA	JudecatoriaSLATINA
MANOLIU	LUCIAN - COSMIN	JudecatoriaSLATINA
OANCEA	ION SILVIU	JudecatoriaSLATINA
OLTEAN	CAMELIA	JudecatoriaSLATINA
PETCAN	ROMEO-IULIAN	JudecatoriaSLATINA
STĂICULESCU	COSTINEL	JudecatoriaSLATINA
STOINEA	VASILICĂ	JudecatoriaSLATINA
BĂLĂŞESCU	LIDIA	JudecatoriaCARACAL
BUZATU	VICTORIA	JudecatoriaCARACAL
DEFTA	DOINA	JudecatoriaCARACAL
GĂLETAN	LUCIA AUGISTINA	JudecatoriaCARACAL
GROZĂVESCU	ION	JudecatoriaCARACAL
IVAN	MARIAN	JudecatoriaCARACAL
MATEI	MIU	JudecatoriaCARACAL
MĂCEŞEANU	CONSTANTIN CRISTINEL	JudecatoriaCARACAL
REZEANU	ION	JudecatoriaCARACAL
SOARE	DANIELA	JudecatoriaCARACAL
STOICEA	MIHAELA ZENOVIA	JudecatoriaCARACAL
TEACU	IOANA	JudecatoriaCARACAL
VESELIN	FLORIN CRISTIAN	JudecatoriaCARACAL
CIOBOATĂ	ELENA MIRELA	JudecatoriaCORABIA
DUŢĂ	RALUCA FLORIANA	JudecatoriaCORABIA
LASCU	ELENA	JudecatoriaCORABIA
NICOLAE	MARIANA	JudecatoriaCORABIA
PAVELESCU	ALINA	JudecatoriaCORABIA
BĂLAN (BRĂCĂCESCU)	AURORA- LOREDANA	JudecatoriaBALS
IGNAT	CRISTIAN	JudecatoriaBALS
ILIESCU	CRISTIAN NICOLAE	JudecatoriaBALS
LEONTE	DANIELA	JudecatoriaBALS
MIHAI	MARILENA	JudecatoriaBALS
PĂUN	LIVIU DANIEL	JudecatoriaBALS
ROTEA	NICOLAIE	JudecatoriaBALS
VÎLCEA	CORNELIA	JudecatoriaBALS
APOSTU	IOAN	CurteadeApelGALATI
BABAN	MARIANA	CurteadeApelGALATI
BACŞIN	SIMONA CLAUDIA	CurteadeApelGALATI
BELIGAN	DRAGOŞ IULIAN	CurteadeApelGALATI
BENESCU	DORU	CurteadeApelGALATI
BLEOANCĂ	ALEXANDRU	CurteadeApelGALATI
BOLDEA	IRINA ALEXANDRA	CurteadeApelGALATI
CÂRCOTĂ	CONSTANTIN	CurteadeApelGALATI
COINĂCEL	MARIOARA	CurteadeApelGALATI
CONSTANTINESCU	DANIELA LILIANA	CurteadeApelGALATI
CRISTEA	ANETA LUMINIŢA	CurteadeApelGALATI
CRISTACHE	MARIANA	CurteadeApelGALATI
DANU	IULIANA MIHAELA	CurteadeApelGALATI
DIMITRIU	VIRGINIA MARIANA	CurteadeApelGALATI
DUMITRU	PETRUS	CurteadeApelGALATI
FILIPESCU	VIRGINIA	CurteadeApelGALATI
FUICĂ	BENONE	CurteadeApelGALATI
HERGHELEGIU	LIVIU	CurteadeApelGALATI
IGNAT	GINA	CurteadeApelGALATI
IOAN	ANICA	CurteadeApelGALATI
ISTRATE	MARCIAN MARIUS	CurteadeApelGALATI
JIRLĂEANU	ROMEO	CurteadeApelGALATI
MÂRZA 	MIŢA	CurteadeApelGALATI
MELEACĂ	FLORIN	CurteadeApelGALATI
MIHAI SECUIANU	VIORICA	CurteadeApelGALATI
MIHĂILĂ	COSMIN RĂZVAN	CurteadeApelGALATI
MIRCEA	AUR MARIAN	CurteadeApelGALATI
NEAGU	MIHAELA	CurteadeApelGALATI
NEAGU	DANIELA	CurteadeApelGALATI
PANŢURU	EMILIA  LENUTA	CurteadeApelGALATI
PĂCURARIU	VERONICA CONSTANŢA	CurteadeApelGALATI
POPA	GEORGE	CurteadeApelGALATI
ROMILĂ	ELENA	CurteadeApelGALATI
SAVIN	ALINA LILIANA	CurteadeApelGALATI
STĂNESCU	DORINA	CurteadeApelGALATI
SURDU	MIHAELA	CurteadeApelGALATI
SUSANU	VASILE	CurteadeApelGALATI
TACEA	MARIANA	CurteadeApelGALATI
TÎLVAR	GEORGETA LUMINIŢA	CurteadeApelGALATI
VRABIE	VALENTINA	CurteadeApelGALATI
ZAHARIA	ALEXANDRINA	CurteadeApelGALATI
ALEXA	MIHAELA	TribunalulGALATI
BENESCU	LUMINIŢA	TribunalulGALATI
CHETRONE	LUCIAN	TribunalulGALATI
CHIRIŢĂ	LILIANA	TribunalulGALATI
COARNA	CRISTINA	TribunalulGALATI
CORTOJAN	ALEXANDRU	TribunalulGALATI
COSTIN	FLORIAN	TribunalulGALATI
CUCOŞ	ANIŞOARA	TribunalulGALATI
DUMITRACHE 	VERONICA	TribunalulGALATI
FILIP	ANGELA	TribunalulGALATI
FLOREA 	ROBERT GEORGE	TribunalulGALATI
GRECU 	MARILENA	TribunalulGALATI
JURJE	RALUCA	TribunalulGALATI
LUCA	CORNELIA	TribunalulGALATI
LUCHIAN	SORINA	TribunalulGALATI
LUNGEANU	MIHAELA ANGELICA	TribunalulGALATI
MÂNDRU	MAGDALENA	TribunalulGALATI
MĂLAI	ALEXANDRA CRISTINA	TribunalulGALATI
MĂRĂCINEANU	DORANDA	TribunalulGALATI
MIRON	RODICA	TribunalulGALATI
MORTU	EUGEN	TribunalulGALATI
MUSCĂ	MAGDALENA	TribunalulGALATI
NECHIFOR	DANIEL GEORGE	TribunalulGALATI
NICULIŢĂ	FLORIN LIVIU	TribunalulGALATI
OANCEA	DIANA MIHAELA	TribunalulGALATI
ONIŞOR	LILIANA ANGELICA	TribunalulGALATI
PERIJOC	PAULA	TribunalulGALATI
PUNGOCI	ANCA	TribunalulGALATI
SANDU	CARMEN	TribunalulGALATI
ZARĂ	RALUCA ELENA	TribunalulGALATI
ARHIP	ANDREEA	JudecatoriaGALATI
ARHIP	MIHAI	JudecatoriaGALATI
BICHILIE	OANA GABRIELA	JudecatoriaGALATI
BRADU	ANDREEA MIHAELA	JudecatoriaGALATI
BRATU	LAURA IRINA	JudecatoriaGALATI
BRUMA	OANA	JudecatoriaGALATI
BORDEIANU	ANDREI	JudecatoriaGALATI
BUTNARU	NICOLETA DANIELA	JudecatoriaGALATI
CHIHAIA	GABRIELA - NICOLETA	JudecatoriaGALATI
CONSTANTINESCU	IONUŢ DANIEL	JudecatoriaGALATI
CRIHANĂ	NORINA VIORICA	JudecatoriaGALATI
DAVID	ELIZA LOREDANA	JudecatoriaGALATI
DĂESCU	ADRIAN	JudecatoriaGALATI
DEDIU	ELENA GEORGIANA	JudecatoriaGALATI
DICU	RĂZVAN	JudecatoriaGALATI
CROITORU	CORINA IONELA	JudecatoriaGALATI
GĂITAN	AUREL	JudecatoriaGALATI
HANU	MAGDALENA	JudecatoriaGALATI
KOLARITZ	MIHAELA	JudecatoriaGALATI
MANEA	ANNE MARIE NICOLETA	JudecatoriaGALATI
MIHAI	MONICA MIHAELA	JudecatoriaGALATI
NEDELCU	GIULIO COSTEL	JudecatoriaGALATI
PÎNZARIU 	CRISTIAN	JudecatoriaGALATI
POPA	CLAUDIA ROXANA	JudecatoriaGALATI
POPA 	ELENA	JudecatoriaGALATI
PUŞCASU	RAMONA NARCISA	JudecatoriaGALATI
CIOBOTARU	CARMEN ELENA	JudecatoriaGALATI
SANDU	ANDREEA	JudecatoriaGALATI
TOMOZEI 	ADRIAN	JudecatoriaGALATI
VIERU 	MONICA	JudecatoriaGALATI
VIJELIE	CĂTĂLIN MIHAI	JudecatoriaGALATI
ZVORIŞTEANU	ANCUŢA	JudecatoriaGALATI
BIRO	NICOLETA	JudecatoriaTECUCI
CIULEI	VALERICA	JudecatoriaTECUCI
FOTACHE	NINA	JudecatoriaTECUCI
GHEORGHE 	ANA MARIA	JudecatoriaTECUCI
ILIE	CORNELIU	JudecatoriaTECUCI
LUNGOCIA	VIORICA GABRIELA	JudecatoriaTECUCI
NIAGU	VIRGINIA MIHAELA	JudecatoriaTECUCI
TUCHILUŞ	NICULINA	JudecatoriaTECUCI
GEORGESCU – ASHEMIMRY	VIOLETA - ELENA	JudecatoriaTARGUBUJOR
MAHU 	ROXANA LUCIA	JudecatoriaTARGUBUJOR
MEREUŢĂ	ADRIAN	JudecatoriaTARGUBUJOR
HALIL	ADRIAN	JudecatoriaLIESTI
MIRON	SIMONA ELENA	JudecatoriaLIESTI
STAMATIU	ORESTE	JudecatoriaLIESTI
ALIONTE	VIORICA	TribunalulBRAILA
BANU	PAUNIŢA	TribunalulBRAILA
BOLDEANU	ANDREEA - ANCA	TribunalulBRAILA
BUCĂLĂU	TRAIAN	TribunalulBRAILA
BURLACU	RADU	TribunalulBRAILA
CĂŞARU	ANY MARY	TribunalulBRAILA
CHIROI	ANAMARIA	TribunalulBRAILA
ICONARU	GABRIELA CORINA	TribunalulBRAILA
IONIŢĂ	MARCELA	TribunalulBRAILA
MOCANU	LENUŢA	TribunalulBRAILA
PAVEL	ALINA ATENA	TribunalulBRAILA
ROMAN	CATALINA HERMINA	TribunalulBRAILA
ROŞ	VASILICA	TribunalulBRAILA
ROŞIORU	AURELIA	TribunalulBRAILA
SPIŢĂ	MIOARA	TribunalulBRAILA
SURDU	MIHAILĂ	TribunalulBRAILA
TĂTARU	MARIN	TribunalulBRAILA
TEODORESCU	CRISTIAN DRAGOŞ	TribunalulBRAILA
VASILE	VIOREL	TribunalulBRAILA
VASILIU	MARIA LUCIA	TribunalulBRAILA
VICOL	DANIELA	TribunalulBRAILA
VOINEA	GEANINA ELENA	TribunalulBRAILA
BOGHIU	DUMITRU	JudecatoriaBRAILA
BUTNARU	CIPRIAN	JudecatoriaBRAILA
BUZEA	LICUŢA	JudecatoriaBRAILA
CIOBANU	IOANA GEORGIANA	JudecatoriaBRAILA
COJOCARIU	MARIUS FLORENTIN	JudecatoriaBRAILA
DAJBOG	LAVINIA	JudecatoriaBRAILA
DENIZ	DIANA GABRIELA	JudecatoriaBRAILA
DIACONESCU MACARENCO	SPERANŢA	JudecatoriaBRAILA
DUMITRU	FLORIN	JudecatoriaBRAILA
EREBACAN	PETRICĂ	JudecatoriaBRAILA
GURIŢĂ – MANOLE	DANIEL	JudecatoriaBRAILA
JOGHIU	SORIN	JudecatoriaBRAILA
LILEA 	MARIAN	JudecatoriaBRAILA
MATYAS	CLAUDIA FLORENTINA	JudecatoriaBRAILA
NEAGU	GEORGETA CLAUDIA	JudecatoriaBRAILA
NICOLAU	ALINA - AURORA	JudecatoriaBRAILA
NICOLAU	BOGDAN	JudecatoriaBRAILA
PERIANU 	RALUCA	JudecatoriaBRAILA
STOICA	DANIELA MARILENA	JudecatoriaBRAILA
ŞERBAN	VIRGIL	JudecatoriaBRAILA
ŞTEFAN	IRINA	JudecatoriaBRAILA
TEODORESCU	DANIELA	JudecatoriaBRAILA
VANK	ADRIAN VICTOR	JudecatoriaBRAILA
VINTILĂ	ANAMARIA	JudecatoriaBRAILA
BUDESCU	AURICA	JudecatoriaFAUREI
IORGA	DRAGOŞ - ADRIAN	JudecatoriaFAUREI
IONESCU	PETRU	JudecatoriaINSURATEI
BEJENARU	IOLANDA LĂCRĂMIOARA	TribunalulVRANCEA
BORDEA	ANETA	TribunalulVRANCEA
BUCUR	SILVICA - MIRELA	TribunalulVRANCEA
COPACI	ADRIANA	TribunalulVRANCEA
COTEA	CARMEN	TribunalulVRANCEA
CROITORU	SĂNDINA  MARIANA	TribunalulVRANCEA
CULIŢĂ	VASILE	TribunalulVRANCEA
DIBUŞ	MARIELA	TribunalulVRANCEA
DIŢĂ	MIRELA	TribunalulVRANCEA
DIŢĂ	COSTICĂ	TribunalulVRANCEA
DUMITRACHE	EMILIA	TribunalulVRANCEA
DUŢĂ	SILVA - GABRIELA	TribunalulVRANCEA
HĂRĂBOR	DOREL	TribunalulVRANCEA
HOLBEA	ROMICĂ	TribunalulVRANCEA
JELEA	DINU	TribunalulVRANCEA
MANOLE	VICTORIA	TribunalulVRANCEA
MATACHE	DANIELA	TribunalulVRANCEA
NEACŞU	VASILICA  VIORICA	TribunalulVRANCEA
NEAGU	RODICA	TribunalulVRANCEA
NICOLAU	SIMONA  FLORICA	TribunalulVRANCEA
POPA	MARIANA	TribunalulVRANCEA
ROŞU	ADRIANA SONIA	TribunalulVRANCEA
SANDU	ELENA	TribunalulVRANCEA
SAVIN	RODICA	TribunalulVRANCEA
TIMOFTE	FLORENTINA	TribunalulVRANCEA
TROFIN	ANCA MIHAELA	TribunalulVRANCEA
VOINEAG	VIOREL	TribunalulVRANCEA
BADIU	MANDICA	JudecatoriaFOCSANI
BOTEZATU	EMILIA	JudecatoriaFOCSANI
CRĂCIUN	CĂTĂLIN CONSTANTIN	JudecatoriaFOCSANI
CORBU	MIHAELA	JudecatoriaFOCSANI
DINU MURGULEŢ	ANA	JudecatoriaFOCSANI
DUŢĂ	LUMINIŢA	JudecatoriaFOCSANI
GRĂDINESCU	MARIANA	JudecatoriaFOCSANI
HĂRĂBOR	LENUŢA	JudecatoriaFOCSANI
ÎMPARATU	ION	JudecatoriaFOCSANI
IONESCU 	RAMONA	JudecatoriaFOCSANI
JELEA	OANA ANDREEA	JudecatoriaFOCSANI
MĂNESCU	GABRIELA ALINA	JudecatoriaFOCSANI
MIHALACHE	FRASINA	JudecatoriaFOCSANI
MÎRJA	ALINA IULIANA	JudecatoriaFOCSANI
MIRON	DOINA	JudecatoriaFOCSANI
NICOLAU	MARILENA	JudecatoriaFOCSANI
ORIŢA	DELIA	JudecatoriaFOCSANI
PASCARU	ANDREEA ANCA	JudecatoriaFOCSANI
PĂUN	IONEL - IULIAN	JudecatoriaFOCSANI
POPESCU	MĂDĂLINA	JudecatoriaFOCSANI
SOARE	LUMINIŢA	JudecatoriaFOCSANI
ŞERBĂNUŢ	IRINA VICTORIA	JudecatoriaFOCSANI
TĂUTU	CONSTANTIN	JudecatoriaFOCSANI
TOPOR	ANIŞOARA	JudecatoriaFOCSANI
CIMPOERU	DANIELA	JudecatoriaPANCIU
OPREA (GALU)	DANIELA	JudecatoriaPANCIU
STOICA	MIHAI FLORIN	JudecatoriaPANCIU
STOICIU	NICULINA	JudecatoriaPANCIU
COJAN	DENISA - MIHAELA	JudecatoriaADJUD
COMĂNESCU	CARMEN	JudecatoriaADJUD
CRISTIAN	MIRCEA - VLAD	JudecatoriaADJUD
ROŞCA	VALERIU	JudecatoriaADJUD
ANDRONIC	ADRIANA-ELENA	CurteadeApelIASI
ANGELESCU	CRISTIANA	CurteadeApelIASI
ANTON	DAN	CurteadeApelIASI
BANCU	CARMEN	CurteadeApelIASI
CHEPTENE MICU	DIANA MIHAELA	CurteadeApelIASI
CHIRILĂ	MIHAELA	CurteadeApelIASI
CIOBANU	IULIA ELENA	CurteadeApelIASI
COCOR	MONICA LILIANA	CurteadeApelIASI
CORMANENCU-STANCIU	VALERIA	CurteadeApelIASI
DUBLEA	AUREL	CurteadeApelIASI
DUMITRESCU	DANIELA	CurteadeApelIASI
GHEORGHE	AURELIA	CurteadeApelIASI
GHEORGHIU	ELENA	CurteadeApelIASI
GHIDEANU	ANCA	CurteadeApelIASI
JUVERDEANU	TATIANA	CurteadeApelIASI
MORUZI	NELIDA-CRISTINA	CurteadeApelIASI
OBREJA MANOLACHE	ANCUŢA GABRIELA	CurteadeApelIASI
OBREJA-MANOLACHE	NELU-IUSTINIAN	CurteadeApelIASI
OLARIU	VIORICA	CurteadeApelIASI
PALIHOVICI	LILIANA	CurteadeApelIASI
PAVELESCU	GEORGETA	CurteadeApelIASI
PINTE	VIOLETA ELENA	CurteadeApelIASI
PIPERNEA	SMARANDA	CurteadeApelIASI
POIANA	CIPRIANA MIHAELA	CurteadeApelIASI
POPA	MARIA CRISTINA	CurteadeApelIASI
PROTEA	GEORGETA	CurteadeApelIASI
PRUTEANU	DANIELA	CurteadeApelIASI
SANDU	GETA	CurteadeApelIASI
SCRIMINŢI	ELENA	CurteadeApelIASI
STOINEL	ADRIANA CARMEN	CurteadeApelIASI
SUSANU	CLAUDIA ANTOANELA	CurteadeApelIASI
ŞERBĂNESCU	DRAGOŞ RADU GABRIEL	CurteadeApelIASI
TABALTOC	DAN MIRCEA	CurteadeApelIASI
TACU	FLORIN MARIUS	CurteadeApelIASI
TARLION	CONSTANTIN GABRIEL	CurteadeApelIASI
TRUŢESCU	CRISTINA	CurteadeApelIASI
ACHIROAEI	CATALINA ELENA	TribunalulIASI
ADAM	OANA CRISTINA	TribunalulIASI
ALEXANDRU	MITICA	TribunalulIASI
AMANCEI	DANIELA	TribunalulIASI
ANDREI	FLORIN ALEXANDRU	TribunalulIASI
ANTON	MIRELA	TribunalulIASI
AROTĂRIŢEI	IULIA-LOREDANA	TribunalulIASI
ARTENIE	ALEXANDRU DAN GABRIEL	TribunalulIASI
BARBIR	CLARA ROXANA	TribunalulIASI
BOTEZ (CAPATA )	CARMEN BEATRIS	TribunalulIASI
CARDONEANU	MARIA-ELIZA	TribunalulIASI
CAZACIUC	CALINA ELENA	TribunalulIASI
CAŞCAVAL	ALICE-MIHAELA	TribunalulIASI
CIOPRAGA	MANUELA	TribunalulIASI
CONACHI	SONICA	TribunalulIASI
CORUGĂ BUTUCĂ	MIHAELA	TribunalulIASI
COSINSCHI	ADRIANA RAMONA	TribunalulIASI
CULEA	GABRIELA	TribunalulIASI
DASCALU	CARMEN	TribunalulIASI
DĂNILĂ	IULIAN	TribunalulIASI
DIACONARU	IULIA	TribunalulIASI
DIACONARU	PETRUŞ CIPRIAN	TribunalulIASI
DIUŢĂ-TOMA	ANA MARIA	TribunalulIASI
GRĂDINARU	BRÂNDUŞA DANIELA	TribunalulIASI
FILIPEANU 	ELENA CRIZANTEMA	TribunalulIASI
FILIPESCU	SILVIA	TribunalulIASI
HARATU	MIHAELA-DANA	TribunalulIASI
IONESCU	CAMELIA - MIHAELA	TribunalulIASI
IOVU	DANIELA	TribunalulIASI
LABUS	ANA CRISTINA	TribunalulIASI
LACUSTA	OANA MONICA	TribunalulIASI
LAZAR	NICOLETA	TribunalulIASI
LUCA	SOFIA	TribunalulIASI
MATEI	MIHAELA	TribunalulIASI
MATEICIUC	MONICA	TribunalulIASI
MIHU	MIHAELA	TribunalulIASI
MIRĂUŢĂ 	DANIEL	TribunalulIASI
MOCANU	MARCEL	TribunalulIASI
PAVEL	ELENA	TribunalulIASI
PREDA	ELENA CRISTINA	TribunalulIASI
PRELIPCEAN	ALINA GIANINA	TribunalulIASI
RADU	CRISTINA	TribunalulIASI
SAMOIL	MARIA	TribunalulIASI
SAVA	CORNELIA CORINA	TribunalulIASI
SIDOR	MIHAELA	TribunalulIASI
SIMA	CRISTINA	TribunalulIASI
ŞTEFĂNIŢĂ	NICOLETA	TribunalulIASI
STOICA	NARCIS- VIOLIN	TribunalulIASI
STRATAN 	MARIA CRISTINA	TribunalulIASI
TARLION	LORENA	TribunalulIASI
TARLION	ŞTEFAN	TribunalulIASI
TATARUSANU	DOINITA	TribunalulIASI
TIMOFTE	ELENA PETRONELA	TribunalulIASI
TODERICĂ	CAMELIA	TribunalulIASI
TRANDAFIR	ANCA MIHAELA	TribunalulIASI
TRIFAN	ANDREEA NICOLETA	TribunalulIASI
VASILIU CRAVELOS	RICA	TribunalulIASI
ZAHARIA	LENUTA- NICOLETA	TribunalulIASI
ACRÎSMARITEI	CAMELIA ALEXANDRINA	JudecatoriaIASI
ADOMNIŢEI	SABINA DANIELA	JudecatoriaIASI
AIONESEI	MARILENA	JudecatoriaIASI
ALEXANDRESCU	ELENA LOREDANA	JudecatoriaIASI
BEJAN	CLAUDIA DANIELA	JudecatoriaIASI
BUICEAG	MIHAELA	JudecatoriaIASI
BULIGA	TATIANA	JudecatoriaIASI
BUTNARU	ELENA CLAUDIA	JudecatoriaIASI
CAZACU	CERASELA MADALINA	JudecatoriaIASI
CIOCOI	IULIAN	JudecatoriaIASI
CODREANU	ALINA	JudecatoriaIASI
COLIBABA 	ANCA DENISA	JudecatoriaIASI
COLIPCA	FLORIN	JudecatoriaIASI
CRĂINICEANU	CRISTIAN - MARIUS	JudecatoriaIASI
CRIŞU - CIOCÎNTĂ	ANDA	JudecatoriaIASI
CURCĂ	MARIA ŞTEFANIA LORENA	JudecatoriaIASI
CUZIC	MARICICA DANIELA	JudecatoriaIASI
DASCĂLU	CRINA ELENA	JudecatoriaIASI
FALCAN	DANIELA MARIA	JudecatoriaIASI
FRANGOPOL	RALUCA MELANIA	JudecatoriaIASI
GAFTA	GEORGETA LACRAMIOARA	JudecatoriaIASI
GHERCA	ROMULUS EUGEN	JudecatoriaIASI
GRADINARIU	IOAN	JudecatoriaIASI
GURBAN	TUDOR	JudecatoriaIASI
HATMANU	LAURA	JudecatoriaIASI
HURJUI	OANA CRISTINA	JudecatoriaIASI
IGNAT	OANA IRINA	JudecatoriaIASI
ILIEŞ	ANA	JudecatoriaIASI
IONIŢĂ	IRINA	JudecatoriaIASI
MACOVEI	ALINA CORNELIA	JudecatoriaIASI
MACOVEI - FOCŞA	SÎNZIANA ELENA	JudecatoriaIASI
MANDACHE	CLAUDIA	JudecatoriaIASI
MOCANU	GEORGIANA CLAUDIA	JudecatoriaIASI
MORARU	MARIUS ANDREI	JudecatoriaIASI
MUNTEANU	IULIA LAVINIA	JudecatoriaIASI
NISTOR	MIHAELA	JudecatoriaIASI
OBREJA	MARIANA	JudecatoriaIASI
PASCARU	VALENTINA ŞTEFANA	JudecatoriaIASI
PLATON	DIANA	JudecatoriaIASI
POPA	ŞTEFAN ANDREI	JudecatoriaIASI
RUSU 	IRINA CORNELIA	JudecatoriaIASI
SAVU	ALINA FELICIA	JudecatoriaIASI
SHANNAK	ANDREEA TEODORA	JudecatoriaIASI
STĂNCULEANU	MARIA GABRIELA	JudecatoriaIASI
ŞTEFĂNESCU	BEATRICE	JudecatoriaIASI
TARLION 	MIHAELA GETA	JudecatoriaIASI
TESCU	IULIANA	JudecatoriaIASI
TIRLEA	IRINA	JudecatoriaIASI
UNGUREANU	ALINA	JudecatoriaIASI
UNGUREANU	CRISTIAN	JudecatoriaIASI
VARVARA	VERONICA CORINA	JudecatoriaIASI
VILCU	CRISTINA GEORGIANA	JudecatoriaIASI
ZAHARIA	IRINA	JudecatoriaIASI
ZAHARIA LEFTER	MARIA OANA	JudecatoriaIASI
ZAHARIA LUPU	FLORIN MIRCEA	JudecatoriaIASI
BABII	VASILE	JudecatoriaPASCANI
CASUNEANU	CONSTANTIN	JudecatoriaPASCANI
CHERECHEŞ	OANA ADELINA	JudecatoriaPASCANI
CHISCA	IULIAN	JudecatoriaPASCANI
CHITIC	IONELA	JudecatoriaPASCANI
COJOCARU	PETRONELA ROXANA	JudecatoriaPASCANI
COSTEA	ANCA NATALIA	JudecatoriaPASCANI
PRISĂCARU	NICOLAE EDUARD	JudecatoriaPASCANI
SERBANESCU	IRINA	JudecatoriaPASCANI
SAVA	MAGDALENA - RALUCA	JudecatoriaPASCANI
STAVARACHE	ANDREIA IRINA	JudecatoriaPASCANI
CHIRIAC	DANIEL	JudecatoriaHARLAU
GHIAŢĂ	ANA - MARIA	JudecatoriaHARLAU
MIHĂILĂ	OANA	JudecatoriaHARLAU
PRISTAVU	CODRIN MIREL	JudecatoriaHARLAU
VARVARA	LUMINIŢA	JudecatoriaHARLAU
AMARIEI	MARIA CLAUDIA	JudecatoriaRADUCANENI
BUIUM	MIRELA GABRIELA	JudecatoriaRADUCANENI
COLIN	MARIANA CORINA	JudecatoriaRADUCANENI
GHERCĂ	DANIELA ELENA	JudecatoriaRADUCANENI
GRIGORAŞ	RALUCA MARIA	JudecatoriaRADUCANENI
AGAFITEI	VASILE	TribunalulVASLUI
AIONIŢOAIE	ELENA GABRIELA	TribunalulVASLUI
ANDRIEŞ	CARMEN	TribunalulVASLUI
BĂLAN 	LAURA MONICA	TribunalulVASLUI
CHIRIAC 	ADRIAN	TribunalulVASLUI
CIOARĂ	MĂDĂLINA	TribunalulVASLUI
FILIP	GABRIELA	TribunalulVASLUI
FILIP	ANA MARIA	TribunalulVASLUI
FOCA	ELENA	TribunalulVASLUI
ISEPCIUC	ELENA RALUCA	TribunalulVASLUI
MANOLE	DANIELA- MIHAELA	TribunalulVASLUI
OANĂ	RADU NICOLAE	TribunalulVASLUI
PASCARU	IOLANDA-MIHAELA	TribunalulVASLUI
SIMIONESCU	ELENA	TribunalulVASLUI
SIRGHI	DIANA-ELENA	TribunalulVASLUI
BRAŞOVEAN	MARINA	JudecatoriaVASLUI
BUDESCU	CORNELIA	JudecatoriaVASLUI
CODINĂ	OANA	JudecatoriaVASLUI
COJAN	ONUŢ	JudecatoriaVASLUI
COJOCARU	ALEXANDRA CRISTINA	JudecatoriaVASLUI
DUMITRIU	ELENA MIRELA	JudecatoriaVASLUI
EŢCU	CORINA	JudecatoriaVASLUI
GHINTUIALA	MIHAELA	JudecatoriaVASLUI
MANTA GRAPĂ	DIANA EUGENIA	JudecatoriaVASLUI
MĂGUREANU	EMANUELA DOINA	JudecatoriaVASLUI
MOLDOVAN	GEORGINA	JudecatoriaVASLUI
MUNTEANU	LETIZIA	JudecatoriaVASLUI
NICOLAU	GABRIELA	JudecatoriaVASLUI
PARVU	CRISTINA	JudecatoriaVASLUI
ROMILA	MIHAELA ROXANA	JudecatoriaVASLUI
STATIVĂ	LUMINIŢA COSMINA	JudecatoriaVASLUI
VEZETEU	CORNELIA	JudecatoriaVASLUI
AIONITOAIE	VERONEL	JudecatoriaBARLAD
BERARU	GINA	JudecatoriaBARLAD
BURLIBASA	NECULAI	JudecatoriaBARLAD
CATRINICI	DIANA	JudecatoriaBARLAD
DARIE	CĂTĂLINA	JudecatoriaBARLAD
ENACHE	GABRIELA	JudecatoriaBARLAD
ISAC	RADITA	JudecatoriaBARLAD
JUGLAN	DANIELA ELENA	JudecatoriaBARLAD
RĂDULESCU	CĂTĂLINA	JudecatoriaBARLAD
ROTARIU	MUGURICA-GABRIELA	JudecatoriaBARLAD
ROTARU	MIHAI	JudecatoriaBARLAD
TELETIN	IULIANA	JudecatoriaBARLAD
ADAM	CORINA	JudecatoriaHUSI
ALEXANDRU	ADINA	JudecatoriaHUSI
ANTOHI	IULIA CRISTINA	JudecatoriaHUSI
BLESNEAG	IULIA	JudecatoriaHUSI
CIOBOTARU	DIANA	JudecatoriaHUSI
TOLONTAN	CORNELIU	JudecatoriaHUSI
ANTIK	LEVENTE FARKAS	CurteadeApelORADEA
BAICAN	LAURA-SIMONA	CurteadeApelORADEA
BALTARETE	SAVINA	CurteadeApelORADEA
BLAGA VASILAN	OVIDIU DANIEL	CurteadeApelORADEA
BLAGA VASILAN	RODICA GABRIELA	CurteadeApelORADEA
CIGAN	DANA MARGARETA	CurteadeApelORADEA
CHIFAN	GABRIEL	CurteadeApelORADEA
CONDROVICI	ADELA IRINA	CurteadeApelORADEA
FILIMON	MARCELA  OLIMPIA	CurteadeApelORADEA
GALEA	IRINA CARMEN	CurteadeApelORADEA
GALES	MARIA	CurteadeApelORADEA
HAIDU	DORINA - MIHAELA	CurteadeApelORADEA
MADUTA	DOINA - MARIANA	CurteadeApelORADEA
MARINESCU	SIMONA CATALINA	CurteadeApelORADEA
MOSINCAT	EUGENIA	CurteadeApelORADEA
ORBAN	CLAUDIA-CARMEN	CurteadeApelORADEA
PANTEA	VIOREL	CurteadeApelORADEA
PATRAUS	ELVIRA MIHAELA	CurteadeApelORADEA
POPA	AURORA	CurteadeApelORADEA
POPOVICI	CORINA RODICA	CurteadeApelORADEA
PUSCAS	MIRCEA	CurteadeApelORADEA
ROMAN	FLORICA	CurteadeApelORADEA
RUS	CLAUDIA FLORINA	CurteadeApelORADEA
SOANE	LAURA MIHAELA	CurteadeApelORADEA
SOTOC	DANIELA -STEFANIA	CurteadeApelORADEA
STAN	AURELIA LENUTA	CurteadeApelORADEA
TARCA	GABRIELA ANA	CurteadeApelORADEA
TATAR	IOANA DINA	CurteadeApelORADEA
TITERLEA	ALINA DANIELA	CurteadeApelORADEA
TOADER	FELICIA DOINA	CurteadeApelORADEA
TRIF	DOINA	CurteadeApelORADEA
VĂSONAN	ALIN	CurteadeApelORADEA
VIDICAN	DENISA DANIELA	CurteadeApelORADEA
BOCHIS	DOREL	TribunalulBIHOR
BOTEA	NADIA  DANA	TribunalulBIHOR
BULZ	LUCREŢIA JULIETA CLAUDIA ANEE MARI	TribunalulBIHOR
CHIRIAC	ADRIANA AURELIA	TribunalulBIHOR
CIOFLAN	ADINA CLAUDIA	TribunalulBIHOR
COMŞA	DIANA-ANCA	TribunalulBIHOR
CRIŞAN	FLORINA-IULIANA	TribunalulBIHOR
CUC	RALUCA BEATRIX	TribunalulBIHOR
DOMOCOŞ	CARMEN ADRIANA 	TribunalulBIHOR
DOSEANU	LOREDANA STELIANA	TribunalulBIHOR
ERDEI	DANA VERONICA	TribunalulBIHOR
FILIMON	FLORIN IOAN	TribunalulBIHOR
GALEA	OVIDIU DANIEL	TribunalulBIHOR
JURJUT-LAZAR	DANIELA MIHAELA	TribunalulBIHOR
MANOLIU	CONSTANTIN	TribunalulBIHOR
MIREA	LORELEY EMSE	TribunalulBIHOR
MOCIRAN	FLORINA -CARMEN	TribunalulBIHOR
MONENCI	IOAN - CRISTIAN	TribunalulBIHOR
MUNTEAN	CRINA ELENA	TribunalulBIHOR
MUSTA 	OVIDIU PETRU	TribunalulBIHOR
OLAH	IONEL	TribunalulBIHOR
POPESCU	ANCA RALUCA	TribunalulBIHOR
RIMILI	MARIA-CECILIA	TribunalulBIHOR
ROSU	DORINELA	TribunalulBIHOR
SABAU	CALIN- TRAIAN	TribunalulBIHOR
STANCE	MARIA	TribunalulBIHOR
TOD	ANGELA	TribunalulBIHOR
TODORUŢ	NICOLAE CRISTIAN	TribunalulBIHOR
TOTU	CRISTINA	TribunalulBIHOR
UNGUR	OTILIA MONICA	TribunalulBIHOR
VARGA	IREN	TribunalulBIHOR
STANCIU	CLAUDIA - MARIA	TribunalulBIHOR
BALOGH	TEODORA - CARMEN	JudecatoriaORADEA
BENDEA	LORIN OVIDIU	JudecatoriaORADEA
BERINDEI	OLIMPIU DANIEL	JudecatoriaORADEA
BERTEA	MARIA ELENA	JudecatoriaORADEA
BUZ	ADRIAN DANIEL	JudecatoriaORADEA
CHIRIAC	SORIN VICTOR	JudecatoriaORADEA
CIUMA	OVIDIU GEORGE	JudecatoriaORADEA
CRACIUN	CRENGUTA JULIETA	JudecatoriaORADEA
DĂNILEŢ	VASILICĂ CRISTI	JudecatoriaORADEA
FLOREA	CORINA MARIA	JudecatoriaORADEA
GAVRA	CORINA MARILENA	JudecatoriaORADEA
GHERMAN	NATALIA – MONICA - LAURA	JudecatoriaORADEA
GLIGOR	LAURA	JudecatoriaORADEA
HAMBĂRAŞ	CIPRIAN	JudecatoriaORADEA
HARJA	RADU CIPRIAN	JudecatoriaORADEA
HULEA	RADU CĂTĂLIN	JudecatoriaORADEA
KEGYES	MONIKA	JudecatoriaORADEA
IAVORSCHI	FLORENTINA	JudecatoriaORADEA
ILISIE	MARIANA	JudecatoriaORADEA
IOVANOVICS	ENIKO SILVIA	JudecatoriaORADEA
MIRON	CARMEN GABRIELA	JudecatoriaORADEA
POP	PATRICIA SORANA FLORINA	JudecatoriaORADEA
POPA 	FLORIN VIOREL	JudecatoriaORADEA
POPOVICI	MONICA	JudecatoriaORADEA
RACOLTA	IOAN MARIAN	JudecatoriaORADEA
RADOCĂ	NICOLETA	JudecatoriaORADEA
RUGINĂ 	OANA ELENA	JudecatoriaORADEA
SECARA	MARIANA	JudecatoriaORADEA
ŞERBAN	RAREŞ VASILE	JudecatoriaORADEA
TEANA	MARCELA DANIELA	JudecatoriaORADEA
TIMIŞ	IOAN	JudecatoriaORADEA
UDROIU – LUCIAN	DELIA	JudecatoriaORADEA
URSU	LAURA CORNELIA	JudecatoriaORADEA
VERDEŞ	MARIA	JudecatoriaORADEA
CAPOTA	MARIUS PAVEL	JudecatoriaBEIUS
ENACHE	VIRGINIA STELLA	JudecatoriaBEIUS
GAVRILA	ANCUTA FLORIANA	JudecatoriaBEIUS
MARTA	CRISTINA OANA	JudecatoriaBEIUS
MICLO	IOANA -FLORENTINA	JudecatoriaBEIUS
POP	ANA - MARIA	JudecatoriaBEIUS
TAU	VASILE	JudecatoriaBEIUS
BOZGA	MARIAN	JudecatoriaMARGHITA
BURLE	MIRCEA	JudecatoriaMARGHITA
GAL	IOAN	JudecatoriaMARGHITA
GRUESCU	MARIA	JudecatoriaMARGHITA
MARIAN	VLAD VALENTIN	JudecatoriaMARGHITA
ONIŢA	DELIA - ANCA	JudecatoriaMARGHITA
CIOARA	ADRIAN - CRISTIAN	JudecatoriaALESD
CIPLEU	ANCA DIANA	JudecatoriaALESD
DUDAS	IOANA- LUMINITA	JudecatoriaALESD
IONESCU	LIANA MARCELA	JudecatoriaALESD
VINKA	ELENA CORINA	JudecatoriaALESD
ARDELEAN	LIVIU PETRU	JudecatoriaSALONTA
BOGDAN	GEORGE IONUŢ	JudecatoriaSALONTA
BRATU	CORINA	JudecatoriaSALONTA
URSUŢ	GABRIELA	JudecatoriaSALONTA
URSUŢA DARABAN	ELENA	JudecatoriaSALONTA
BOLDUT	GHEORGHE TEOFIL	TribunalulSATUMARE
CADAR	RAMONA MARIA ELENA	TribunalulSATUMARE
CIORCAS	MIHAI	TribunalulSATUMARE
DRAGOŞ	ADELA	TribunalulSATUMARE
DUŢULESCU	MIHAELA	TribunalulSATUMARE
GROSOS MAXIM	RODICA	TribunalulSATUMARE
HAIDUC 	SIMONA MANUELA	TribunalulSATUMARE
KISS	ZITA	TribunalulSATUMARE
MICLE	LAURA ISABELLA	TribunalulSATUMARE
MIHAI COMAN	GELU	TribunalulSATUMARE
MIHAI COMAN	ILEANA	TribunalulSATUMARE
MUREŞAN	CARDONEL FELIX	TribunalulSATUMARE
NEMES	REMUS VASILE	TribunalulSATUMARE
PREDA-TARNOVEANU	CAMELIA NILDA	TribunalulSATUMARE
ROSIORU	EUGEN	TribunalulSATUMARE
RUBA	MARIA GEORGETA	TribunalulSATUMARE
SALAJAN	MARTA RITA	TribunalulSATUMARE
STEFAN	PAULA-GABRIELA	TribunalulSATUMARE
SUCEVEANU	GABRIELA DIANA	TribunalulSATUMARE
TODOR	TAMAS	TribunalulSATUMARE
VÎLCU	ADRIANA MARIANA	TribunalulSATUMARE
BOLDIŞOR	MARIANA CARMEN	JudecatoriaSATUMARE
BRANDUSAN	DORINA MARINELA	JudecatoriaSATUMARE
COJOCARIU	DANA GIGLIOLA	JudecatoriaSATUMARE
COSTE PALINCAŞ	SIMONA ALINA	JudecatoriaSATUMARE
DONKA	ENIKO EVA	JudecatoriaSATUMARE
FROICU	DIANA	JudecatoriaSATUMARE
HOTCA	CRINA CORINA	JudecatoriaSATUMARE
MINCĂ	DIANA ELIZA	JudecatoriaSATUMARE
MORARU	CRISTIAN	JudecatoriaSATUMARE
NEAGOE	CORINA DIANA	JudecatoriaSATUMARE
OPRESCU	NADEJDA	JudecatoriaSATUMARE
PETER	EUGEN MARIUS	JudecatoriaSATUMARE
PETRE	ANAMARIA	JudecatoriaSATUMARE
POP	CAMELIA ANA	JudecatoriaSATUMARE
SALAGEAN	MONICA CORINA	JudecatoriaSATUMARE
SCRIDON	ANA-MARIA	JudecatoriaSATUMARE
SOPONAR	SIMONA – ADRIANA - ELENA	JudecatoriaSATUMARE
SURD	GRIGORE	JudecatoriaSATUMARE
TRIP	MARIA MAGDALENA	JudecatoriaSATUMARE
ZBONA	CLAUDIU - ADRIAN	JudecatoriaSATUMARE
ADOMNIŢEI	COSMIN	JudecatoriaCAREI
ARDELEAN	ANGHEL GHEORGHE	JudecatoriaCAREI
COSTASI	SIMONA MINODORA	JudecatoriaCAREI
STROESCU	CRISTINA-ANTOANETA	JudecatoriaCAREI
TENTER	IOAN RADU	JudecatoriaCAREI
CÂRSTEA	FLORIN	JudecatoriaNEGRESTIOAS
CIORBA	ADRIAN OVIDIU SIMION	JudecatoriaNEGRESTIOAS
ENE SOLOMCIUC	FLORIN CRISTIAN	JudecatoriaNEGRESTIOAS
MOIS	MARIA	JudecatoriaNEGRESTIOAS
ACHIM	GINA	CurteadeApelPITESTI
ANDREESCU	MARIUS	CurteadeApelPITESTI
ANDREI	FLORINA	CurteadeApelPITESTI
BATRANU	IOANA	CurteadeApelPITESTI
BĂDESCU	VERONICA	CurteadeApelPITESTI
CHIORNITA	GABRIELA DORINA	CurteadeApelPITESTI
CIORASCU 	FLORINITA	CurteadeApelPITESTI
COCULESCU	ANA MARIA	CurteadeApelPITESTI
COTOVANU	PAULA ANDRADA	CurteadeApelPITESTI
DIACONU	DUMITRU	CurteadeApelPITESTI
DIACONU	GHEORGHE	CurteadeApelPITESTI
DINESCU	ANAMARIA LAURA	CurteadeApelPITESTI
DUMITRACHE	JEANA	CurteadeApelPITESTI
DUTESCU	CONSTANTINA	CurteadeApelPITESTI
GHEORGHE - SORESCU	TEODORA	CurteadeApelPITESTI
IONIŢĂ 	LAURA	CurteadeApelPITESTI
MERCAN	DORU	CurteadeApelPITESTI
MIRITA	IOANA	CurteadeApelPITESTI
NANU	GHEORGHITA	CurteadeApelPITESTI
NUTA	GEORGETA CORINA	CurteadeApelPITESTI
PĂŞTIN	NICOLETA SIMONA	CurteadeApelPITESTI
PINCU   IFRIM	CORINA	CurteadeApelPITESTI
PLUTEANU	ANDA MIHAELA	CurteadeApelPITESTI
RADU	DANIEL	CurteadeApelPITESTI
REBECA	ION	CurteadeApelPITESTI
RUSU	ELENA MINODORA	CurteadeApelPITESTI
SANDULESCU	MARIUS GABRIEL	CurteadeApelPITESTI
ŞIMONESCU – DIACONU	RALUCA ELENA	CurteadeApelPITESTI
TABACU	ANDREEA ELENA	CurteadeApelPITESTI
TANASE	IRINA	CurteadeApelPITESTI
TERZEA	ANCA ANDREEA	CurteadeApelPITESTI
TOGAN	LICA	CurteadeApelPITESTI
TRANDAFIR	EMILIA RALUCA	CurteadeApelPITESTI
UNGUREANU	ELENA DIANA	CurteadeApelPITESTI
URSU	SANDA	CurteadeApelPITESTI
VOICU	CORINA	CurteadeApelPITESTI
ANTON	ELENA	TribunalulARGES
BADEA	MIHAELA	TribunalulARGES
BECK	CELLIA	TribunalulARGES
CALIN  EROS	ELENA MANUELA	TribunalulARGES
CAPITANESCU	NICOLETA IULIANA	TribunalulARGES
COMANECI   MOSNEANU	EMANUELA	TribunalulARGES
DANCIU	AURELIA	TribunalulARGES
DUMITRACHE  BABALIC	MARIANA  MIRELA	TribunalulARGES
DUMITRAŞCU	OLGA MIHAELA	TribunalulARGES
DUMITRESCU	MARINELA CORNELIA	TribunalulARGES
DUMITRESCU	MARIUS	TribunalulARGES
DUTA	ANETA	TribunalulARGES
FUNDĂTUREANU	IOAN	TribunalulARGES
GRIGORE	RALUCA	TribunalulARGES
IONIŢĂ	IONEL CRISTIAN	TribunalulARGES
LAZAR	IRINA MIHAELA	TribunalulARGES
LINŢA	ALEXANDRA	TribunalulARGES
MATEESCU	ALINA MIHAELA	TribunalulARGES
NĂSTASE	GABRIELA DIANA	TribunalulARGES
NEACŞA	IOANA - MIHAELA	TribunalulARGES
NEACSU	GHEORGHE	TribunalulARGES
PAPAIANOPOL	MAGDALENA VIORICA	TribunalulARGES
PARVU	IOANA	TribunalulARGES
POSTELNICESCU	MARIA CORINA	TribunalulARGES
PRUNARU	ANDREEA MONICA	TribunalulARGES
SACHELARIE	NIFON	TribunalulARGES
SOARE	PATRICEA LORELA	TribunalulARGES
TERZEA	VIOREL	TribunalulARGES
ŢÎNŢU	SONIA IONELA	TribunalulARGES
VIŞINOIU	RUXANDRA	TribunalulARGES
VÎRTOPEANU	VALERICA	TribunalulARGES
VÂRGĂ	MARIANA	TribunalulARGES
APOSTOL	GABRIEL	JudecatoriaPITESTI
APOSTOL	GABRIELA	JudecatoriaPITESTI
APOSTOLESCU	ALINA GABRIELA	JudecatoriaPITESTI
ARGEŞEANU	DUMITRU DANIEL	JudecatoriaPITESTI
BADICEANU	ILENUTA	JudecatoriaPITESTI
BARBULESCU	ELENA LUMINITA	JudecatoriaPITESTI
CAPLAN	ADRIANA	JudecatoriaPITESTI
DIACONU	ANDREEA CARMEN	JudecatoriaPITESTI
DUMBRAVĂ	ANA-MARIA	JudecatoriaPITESTI
DUMITRU	DUMITRU - DANIEL	JudecatoriaPITESTI
ENE	CORNELIA INGE	JudecatoriaPITESTI
FODOR	ELENA	JudecatoriaPITESTI
GRĂDINARIU	MARIA ALIS	JudecatoriaPITESTI
ION	IOANA CRISTINA	JudecatoriaPITESTI
IONESCU	GEORGETA	JudecatoriaPITESTI
IORDACHE	GABRIELA	JudecatoriaPITESTI
MERCAN	LIVIA MARIA	JudecatoriaPITESTI
MIHAI	ANCA ANAMARIA	JudecatoriaPITESTI
MITROFAN	FLORINA	JudecatoriaPITESTI
NEL	CĂTĂLINA 	JudecatoriaPITESTI
PÎRVU	ELENA-CAMELIA	JudecatoriaPITESTI
POPESCU 	LIVIA	JudecatoriaPITESTI
POPESCU	ADELA	JudecatoriaPITESTI
RADULESCU  	ANCA-GEORGIANA	JudecatoriaPITESTI
RUGEA (BĂLULESCU)	ANDREEA ROZALIA	JudecatoriaPITESTI
SCARLAT - COMANESCU	IONUT	JudecatoriaPITESTI
STAN	MIRCEA	JudecatoriaPITESTI
STANCU	DANA IULIANA	JudecatoriaPITESTI
STANCU	COSTIN ANDREI	JudecatoriaPITESTI
STOICESCU	MELANIA CRISTINA	JudecatoriaPITESTI
VIOREANU		JudecatoriaPITESTI
VOICESCU	FILOFTEIA	JudecatoriaPITESTI
AUSTRIANU	ELENA ALINA	JudecatoriaCAMPULUNG
BERECHET COMANESCU	GABRIELA	JudecatoriaCAMPULUNG
CAPLAN	ADRIANA	JudecatoriaCAMPULUNG
DIACONESCU	SANDA	JudecatoriaCAMPULUNG
NICOLAE	CONSTANTIN	JudecatoriaCAMPULUNG
NICOLESCU	VIOLETA	JudecatoriaCAMPULUNG
OPREA	ANA DENIS	JudecatoriaCAMPULUNG
POPA	ADRIANA	JudecatoriaCAMPULUNG
POPESCU	IULIANA	JudecatoriaCAMPULUNG
ROIBU	GEORGETA	JudecatoriaCAMPULUNG
TUDOR	AVRAM	JudecatoriaCAMPULUNG
VISOIU	OTILIA	JudecatoriaCAMPULUNG
BLEJAN	ALEXANDRU	JudecatoriaCURTEADEARGES
BRATU	MARIAN - MIREL	JudecatoriaCURTEADEARGES
IONESCU	GEORGE NICOLAE	JudecatoriaCURTEADEARGES
PAHONTU	GABRIELA	JudecatoriaCURTEADEARGES
POPA	CRISTINA MIRELA	JudecatoriaCURTEADEARGES
STANA	CORNELIU ADRIAN	JudecatoriaCURTEADEARGES
TACHE	ELEONORA	JudecatoriaCURTEADEARGES
UNGUREANU	MIHAELA	JudecatoriaCURTEADEARGES
ACHIM	ALINA MIHAELA	JudecatoriaCOSTESTI
ANTON	CARMEN NICOLETA	JudecatoriaCOSTESTI
BOGDAN	DUMITRU CRISTIAN	JudecatoriaCOSTESTI
BOROŞ	MARGARETA	JudecatoriaCOSTESTI
BOTIŞ	GEORGIANA - OLIVIA	JudecatoriaCOSTESTI
ENE	LIGIA	JudecatoriaTOPOLOVENI
FRUJINĂ	OFELIA RALUCA	JudecatoriaTOPOLOVENI
NEACSU	DANIELA	JudecatoriaTOPOLOVENI
OSIAC	ALINA - NICOLETA	JudecatoriaTOPOLOVENI
BĂDESCU	LEONARD	TribunalulComercialARGES
COPAE	GEORGICA  VALERIU	TribunalulComercialARGES
FUNDĂTUREANU	ADINA	TribunalulComercialARGES
IONESCU	MARIA RUXANDRA	TribunalulComercialARGES
MIHALCEA	GHEORGHE	TribunalulComercialARGES
PERSU	ION	TribunalulComercialARGES
POPAIACU	MIHAELA	TribunalulComercialARGES
POPESCU	IRINEL LIA	TribunalulComercialARGES
TOGAN	DANIELA	TribunalulComercialARGES
ANDREI	ION	TribunalulVALCEA
ANTONIE	MARGARETA	TribunalulVALCEA
BONCIU	GHEORGHE	TribunalulVALCEA
BONCIU	VIORICA	TribunalulVALCEA
CAZANGIU	MIHAELA CAMELIA	TribunalulVALCEA
CERBEANU	GHEORGHE	TribunalulVALCEA
CERNEA	MIRELA	TribunalulVALCEA
CONSTANTINESCU	BOGDAN-FLORIN	TribunalulVALCEA
DEACONESCU	BETINA CAMELIA	TribunalulVALCEA
DINA	GELU	TribunalulVALCEA
DINESCU	PETRE	TribunalulVALCEA
FLOROIU	ELENA CRISTINA	TribunalulVALCEA
GALESANU	DUMITRU	TribunalulVALCEA
GHEORGHITA	ADRIAN MUGUREL	TribunalulVALCEA
HODOROGEA	ADELA-RAMONA	TribunalulVALCEA
LUNGU	ELENA CRISTINA	TribunalulVALCEA
MARINA	ANDRA RODICA	TribunalulVALCEA
MARINA	EMIL	TribunalulVALCEA
MATEESCU	CARMEN ADELUŢA	TribunalulVALCEA
MIHAESCU CEAUSESCU	LILIANA	TribunalulVALCEA
MITRA	DANUT	TribunalulVALCEA
NICOLĂESCU	MIRELA	TribunalulVALCEA
PETRIA	SORINEL	TribunalulVALCEA
PREDESCU	VALERIAN	TribunalulVALCEA
STEFAN	SILVIA	TribunalulVALCEA
STEFANESCU	NICOLAE  LUCIAN	TribunalulVALCEA
VASILESCU 	MARIA	TribunalulVALCEA
VERDES	EUGENIA CARMEN	TribunalulVALCEA
VÎLVOI	DENISA	TribunalulVALCEA
BACIU	ROSITA ELISABETA	JudecatoriaRAMNICUVALCEA
BALACEANU	DALIA	JudecatoriaRAMNICUVALCEA
CHIRVASIU	MIHAELA	JudecatoriaRAMNICUVALCEA
CIAUSESCU	CARMEN - FLORINA	JudecatoriaRAMNICUVALCEA
CONSTANTINESCU	ALINA	JudecatoriaRAMNICUVALCEA
CONSTANTINESCU	FELICIA	JudecatoriaRAMNICUVALCEA
DINA	CARMEN ELENA	JudecatoriaRAMNICUVALCEA
DINU	CAMELIA	JudecatoriaRAMNICUVALCEA
DINU	ELADIEA	JudecatoriaRAMNICUVALCEA
DRAGAN	CERASELA -DIANA	JudecatoriaRAMNICUVALCEA
DRAGAN	MITU	JudecatoriaRAMNICUVALCEA
DUMITRAŞCU	MIOARA	JudecatoriaRAMNICUVALCEA
DUMITRESCU	VALENTINA MIRELA	JudecatoriaRAMNICUVALCEA
FLORICIOIU	SMARANDA MARIA	JudecatoriaRAMNICUVALCEA
FRUNZA	AURELIA	JudecatoriaRAMNICUVALCEA
FULGA	VIOLETA	JudecatoriaRAMNICUVALCEA
GEORGESCU	FELICIA CARMEN	JudecatoriaRAMNICUVALCEA
ILINA	CARMEN CRISTIANA	JudecatoriaRAMNICUVALCEA
LACUSTEANU	GHERGHINA	JudecatoriaRAMNICUVALCEA
LUMINEANU	MARIUS ALEXANDRU	JudecatoriaRAMNICUVALCEA
MATEESCU	MIHAI BOGDAN	JudecatoriaRAMNICUVALCEA
STELESCU	ELENA-CRISTINA	JudecatoriaRAMNICUVALCEA
TUGLUI	CORINA ANCA	JudecatoriaRAMNICUVALCEA
VLAD	VALENTIN	JudecatoriaRAMNICUVALCEA
CĂLINESCU	IRINA OLIVIA	JudecatoriaDRAGASANI
CÎRSTEA	EMILIA	JudecatoriaDRAGASANI
COSEREA	CONSTANTIN	JudecatoriaDRAGASANI
IANCU	DANIELA	JudecatoriaDRAGASANI
LICIU	IOANA HERMINA	JudecatoriaDRAGASANI
PREDESCU	DANIELA	JudecatoriaDRAGASANI
ROESCU	IOANA ANDREEA	JudecatoriaDRAGASANI
SAMOILĂ	OCTAVIAN	JudecatoriaDRAGASANI
STALPEANU	LUMINITA	JudecatoriaDRAGASANI
UDRESCU	DOINA	JudecatoriaDRAGASANI
BIGIOI	ION	JudecatoriaHOREZU
CRISAN	VALENTINA	JudecatoriaHOREZU
DIACONEASA	MIRABELA MAGDA	JudecatoriaHOREZU
LACĂTUŞU	ELENA	JudecatoriaHOREZU
LIŢĂ	MARIUS	JudecatoriaHOREZU
ULARIU	CONSTANTIN CLAUDIU	JudecatoriaHOREZU
BUTOERU NICULESCU	OANA	JudecatoriaBREZOI
DICU	SIMONA ELENA	JudecatoriaBREZOI
FIEROIU	ALEXANDRU OCTAVIAN	JudecatoriaBREZOI
RUSU	MONICA	JudecatoriaBREZOI
		JudecatoriaBREZOI
TUTA	DANIELA	JudecatoriaBREZOI
ANDREI	DELIA	JudecatoriaBALCESTI
CÎRSTEA	MARCU AURELIAN	JudecatoriaBALCESTI
DECĂ	PETRE ELEODOR	JudecatoriaBALCESTI
MITITELU	CATALIN - CONSTANTIN	JudecatoriaBALCESTI
ROBU	VIVIANA OANA	JudecatoriaBALCESTI
ANDRONE	LILIANA-FELICIA	CurteadeApelPLOIESTI
BOTEZ	ANDRA-CORINA	CurteadeApelPLOIESTI
BROTAC	PAULA CRISTINA	CurteadeApelPLOIESTI
BUZOIANU	PETRUTA SIMONA 	CurteadeApelPLOIESTI
CRĂCIUNOIU 	LUCIAN CONSTANTIN	CurteadeApelPLOIESTI
DIACONU	GABRIELA	CurteadeApelPLOIESTI
DINU	DANIEL	CurteadeApelPLOIESTI
DINU	FLORENTINA	CurteadeApelPLOIESTI
DUBOŞARU	RODICA	CurteadeApelPLOIESTI
DUMITRU	VIOLETA	CurteadeApelPLOIESTI
ENESCU	DAN - ANDREI	CurteadeApelPLOIESTI
FRĂŢILESCU	PAUL MIHAI	CurteadeApelPLOIESTI
GEORGESCU	CRISTINA	CurteadeApelPLOIESTI
GEORGESCU	DIANA MUŞATA	CurteadeApelPLOIESTI
GHEORGHE	VALENTINA	CurteadeApelPLOIESTI
GHERASIM	ELISABETA	CurteadeApelPLOIESTI
GHICULESCU	ADRIAN REMUS	CurteadeApelPLOIESTI
GRAURE	PETROSINA MĂDĂLINA	CurteadeApelPLOIESTI
GRECU	MADALINA ELENA	CurteadeApelPLOIESTI
GRECU	MIOARA IOLANDA	CurteadeApelPLOIESTI
GRIGORE	MIRELA	CurteadeApelPLOIESTI
GROZESCU	VERONICA	CurteadeApelPLOIESTI
LAZĂR 	ELENA - SIMONA	CurteadeApelPLOIESTI
LOGOJAN	TRAIAN	CurteadeApelPLOIESTI
LUCĂCEL	IULIANA	CurteadeApelPLOIESTI
MĂRĂCINEANU	VASILE	CurteadeApelPLOIESTI
MARIN	ELIZA	CurteadeApelPLOIESTI
MOICEANU	CRISTINA MIHAELA	CurteadeApelPLOIESTI
NEGULESCU	ELENA	CurteadeApelPLOIESTI
NIŢU	TEODOR	CurteadeApelPLOIESTI
NONEA	IOANA	CurteadeApelPLOIESTI
PANAIT	MARILENA	CurteadeApelPLOIESTI
PIGUI	CRISTINA	CurteadeApelPLOIESTI
POPA	AURELIA	CurteadeApelPLOIESTI
POPESCU	VERA-ANDREA	CurteadeApelPLOIESTI
PREPELIŢĂ	GABRIELA SORINA	CurteadeApelPLOIESTI
RADU	ADRIANA - MARIA	CurteadeApelPLOIESTI
SECREŢEANU	ADRIANA FLORINA	CurteadeApelPLOIESTI
STAICU	ELENA	CurteadeApelPLOIESTI
STAN	LILIANA-AIDA	CurteadeApelPLOIESTI
STANCIU	VIOLETA	CurteadeApelPLOIESTI
STĂNESCU	IONEL	CurteadeApelPLOIESTI
STĂNESCU	VERONICA IZABELA	CurteadeApelPLOIESTI
ŞTEFAN	CONSTANTA	CurteadeApelPLOIESTI
STELIAN	ION	CurteadeApelPLOIESTI
STOICESCU	MARIA	CurteadeApelPLOIESTI
ŞTEFĂNESCU	IOANA CRISTINA	CurteadeApelPLOIESTI
TĂNĂSESCU	MARIANA	CurteadeApelPLOIESTI
TĂNĂSICA	ELENA	CurteadeApelPLOIESTI
TEIŞANU	FLORENTIN	CurteadeApelPLOIESTI
TUDORAN	MIHAI VIOREL	CurteadeApelPLOIESTI
TUDOSE	ANA ROXANA	CurteadeApelPLOIESTI
ZĂINESCU	ELENA	CurteadeApelPLOIESTI
ALEXANDRU	FELIX	TribunalulBUZAU
APOSTU	GEORGETA	TribunalulBUZAU
BARBU	VALENTIN	TribunalulBUZAU
BÂRLODEANU	MĂDĂLINA	TribunalulBUZAU
BRATU	VASILE	TribunalulBUZAU
COŢOFANĂ	MARIANA	TribunalulBUZAU
DRĂGHIA	ANA ELENA	TribunalulBUZAU
DUŢOIU	ANA MARIA	TribunalulBUZAU
FLORESCU	CONSTANTIN	TribunalulBUZAU
GHIURU	IOANA	TribunalulBUZAU
IANA	MARIUS	TribunalulBUZAU
IRIMIA	EUGEN	TribunalulBUZAU
JILAVU	CLARA MAGDALENA	TribunalulBUZAU
MIU	ANGELICA	TribunalulBUZAU
MOCANU	IULIA	TribunalulBUZAU
MUŞETESCU	FILOFTEIA	TribunalulBUZAU
NAZARIE 	MIHAELA	TribunalulBUZAU
OPREA	MARIA	TribunalulBUZAU
PREDA	COSMIN FLORIN	TribunalulBUZAU
PUŞCĂ	AUREL	TribunalulBUZAU
PUŞCĂ 	EUGENIA	TribunalulBUZAU
RĂDUCAN-GRIGORE	ION	TribunalulBUZAU
RIDICHIE	DANIELA NICOLETA	TribunalulBUZAU
ŞERCAIANU	MARIA	TribunalulBUZAU
STAN	GABRIELA	TribunalulBUZAU
STĂNESCU	MIHAIL GABRIEL	TribunalulBUZAU
VĂSÎI	ELENA GEANINA	TribunalulBUZAU
ALEXANDRU	LILIANA ALINA	JudecatoriaBUZAU
ANDRONE	CARMEN	JudecatoriaBUZAU
ARSENI	BOGDAN CONSTANTIN	JudecatoriaBUZAU
BUNEA	ANDREEA ŞTEFANIA	JudecatoriaBUZAU
BURLACU	MIRELA ADRIANA	JudecatoriaBUZAU
CĂCIULĂ	ANCA - ELENA	JudecatoriaBUZAU
CÂRSTEA	ADRIAN - MIHAI	JudecatoriaBUZAU
CÎMPEANU	IULIANA	JudecatoriaBUZAU
DUMITRU	PARASCHIVA	JudecatoriaBUZAU
DRĂGULESCU	LEONTIN	JudecatoriaBUZAU
FRIGEA	LARISA RODICA	JudecatoriaBUZAU
IANOŞ	VIRGIL CONSTANTIN	JudecatoriaBUZAU
ILIESCU 	FELICIA NICOLETA	JudecatoriaBUZAU
IVANOV	ECATERINA	JudecatoriaBUZAU
MARIN	MARIETA	JudecatoriaBUZAU
MĂRGĂRIT	SIMONA	JudecatoriaBUZAU
MIHĂILĂ  	ADRIANA	JudecatoriaBUZAU
NĂSTĂSOIU 	NELU	JudecatoriaBUZAU
NEAGU	RADU IONUŢ	JudecatoriaBUZAU
NICOLAE	ADRIANA	JudecatoriaBUZAU
NICULA 	GABRIELA	JudecatoriaBUZAU
POP	ELENA	JudecatoriaBUZAU
ROMAN	LAVINIA	JudecatoriaBUZAU
ROŞCA	VASILICA	JudecatoriaBUZAU
UŢĂ 	MARCELA	JudecatoriaBUZAU
VĂSI	ANA MARIA	JudecatoriaBUZAU
VLAD	ELENA CRISTINA	JudecatoriaBUZAU
BOGDAN	MARIEANA	JudecatoriaRAMNICUSARAT
CRISTESCU	MIHAELA-CAMELIA	JudecatoriaRAMNICUSARAT
DONEA	MIOARA	JudecatoriaRAMNICUSARAT
FÂŞIE	ŞTEFANA	JudecatoriaRAMNICUSARAT
PRICOP	RĂZVAN IONUŢ	JudecatoriaRAMNICUSARAT
PRODEA	AURA	JudecatoriaRAMNICUSARAT
RĂILEANU	IONEL	JudecatoriaRAMNICUSARAT
GAVRILĂ	MARIA -MACRINA	JudecatoriaPATARLAGELE
MĂNĂILESCU	STEFAN	JudecatoriaPATARLAGELE
NICOLAI	ANDREEA DACIANA	JudecatoriaPATARLAGELE
TOADER	NECULAE	JudecatoriaPATARLAGELE
BĂDULESCU	MARIAN	JudecatoriaPOGOANELE
GOLOIU	ION	JudecatoriaPOGOANELE
PANTAZI	CRENGUTA ELENA	JudecatoriaPOGOANELE
PÎSLARU	CRISTIAN DANIEL	JudecatoriaPOGOANELE
PUTERE	CRISTINA	JudecatoriaPOGOANELE
BĂLAŞA	GABRIEL	TribunalulDAMBOVITA
BĂLAŞA	LUMINITA	TribunalulDAMBOVITA
BANU	LAURA ADRIANA	TribunalulDAMBOVITA
BĂDICEANU 	ILENUŢA	TribunalulDAMBOVITA
BRÎNZICĂ	BOGDANA	TribunalulDAMBOVITA
CHIRA	ION	TribunalulDAMBOVITA
CHIRA	NICOLETA	TribunalulDAMBOVITA
CIOCOIU	GHEORGHE	TribunalulDAMBOVITA
CRISTEA	GRETY	TribunalulDAMBOVITA
DANCIU	MONICA-ELENA	TribunalulDAMBOVITA
DIACONESCU	MIHAELA SIMONA	TribunalulDAMBOVITA
DUCU	CARMEN - IRINEL	TribunalulDAMBOVITA
DUVALMĂ	SIMONA MARIANA	TribunalulDAMBOVITA
EFTENE	FLORIN	TribunalulDAMBOVITA
ERCULESCU	NARCIS	TribunalulDAMBOVITA
FLOREA	SORINA ELENA	TribunalulDAMBOVITA
GOGESCU	CRISTINA MARILENA	TribunalulDAMBOVITA
GOGIOIU	ANA MARIA	TribunalulDAMBOVITA
ILIE	ELENA	TribunalulDAMBOVITA
IORDACHE	MARIA	TribunalulDAMBOVITA
LUNESCU	LILIANA	TribunalulDAMBOVITA
MIHĂLCIOIU 	CARMEN - ELENA	TribunalulDAMBOVITA
MILOŞIOIU	ION	TribunalulDAMBOVITA
MIRIŢOIU	MARIA	TribunalulDAMBOVITA
MOTOROIU	ADRIANA LILIANA	TribunalulDAMBOVITA
NEGREA	SIMINA	TribunalulDAMBOVITA
PANTILIN	ROXANA	TribunalulDAMBOVITA
POPESCU	GHEORGHE	TribunalulDAMBOVITA
POPOIAG	DRAGOŞ CONSTANTIN	TribunalulDAMBOVITA
SOARE	ANASTASIA	TribunalulDAMBOVITA
SPĂTARU	GABRIELA	TribunalulDAMBOVITA
ŞTEFAN	FLORINA DOINA	TribunalulDAMBOVITA
STOICA	ION	TribunalulDAMBOVITA
ZEGHERU	TAMARA MIHAELA	TribunalulDAMBOVITA
ANGHELESCU	FELICIA	JudecatoriaTARGOVISTE
BARBU	LAVINIA ELENA	JudecatoriaTARGOVISTE
CĂRPINIŞ	PETRE DĂNUT	JudecatoriaTARGOVISTE
CHIVU	MARINELA	JudecatoriaTARGOVISTE
CRISTACHE	IRINA CAMELIA	JudecatoriaTARGOVISTE
FEURDEAN	RAMONA MARINA	JudecatoriaTARGOVISTE
GĂIŞTEANU	LAURA VALI	JudecatoriaTARGOVISTE
IGA	MONICA MARIA	JudecatoriaTARGOVISTE
ISTRATE	MANUELA - CRISTINA	JudecatoriaTARGOVISTE
LIXĂNDROIU	ELENA	JudecatoriaTARGOVISTE
MARCU	DOINA LENUTA	JudecatoriaTARGOVISTE
NAE	ILEANA ALINA	JudecatoriaTARGOVISTE
NICOLAE	MIREL AUGUSTIN	JudecatoriaTARGOVISTE
OPREA	GHEORGHE	JudecatoriaTARGOVISTE
PREDA	SIMONA CLAUDIA	JudecatoriaTARGOVISTE
SIMESCU	FLORIN	JudecatoriaTARGOVISTE
SPĂTARU	LUIZA MIHAELA	JudecatoriaTARGOVISTE
STAN	AMALIA - VERONICA	JudecatoriaTARGOVISTE
STOIAN	IONUŢ ALEXANDRU	JudecatoriaTARGOVISTE
ŞELARU	MARIA DIANA	JudecatoriaTARGOVISTE
TOMA	ELENA MIHAELA	JudecatoriaTARGOVISTE
CIOBANIŢĂ 	CRISTIANA	JudecatoriaGAESTI
CRISTESCU	DORY DANIELA	JudecatoriaGAESTI
DINU	MARIUS	JudecatoriaGAESTI
DRĂGAN	MIHAI	JudecatoriaGAESTI
MARIN	MINA	JudecatoriaGAESTI
NAN 	MEDA - ELENA	JudecatoriaGAESTI
OCEANU	ALINA - MARIA	JudecatoriaGAESTI
POPESCU	MIHAELA	JudecatoriaGAESTI
MUNTEANU	OANA - OCTAVIA	JudecatoriaPUCIOASA
MURARU	GEORGIANA	JudecatoriaPUCIOASA
MUŞUROIU	DIANA	JudecatoriaPUCIOASA
POPESCU	OCTAVIAN ADRIAN	JudecatoriaPUCIOASA
ANCU	CRISTIAN - CONSTANTIN	JudecatoriaRACARI
DAICU	MIHAELA	JudecatoriaRACARI
DRĂGHICI	ALIS - CĂTĂLINA	JudecatoriaRACARI
MASTACAN	NADIA - MARIA	JudecatoriaRACARI
SIMION	RALUCA - ELENA	JudecatoriaRACARI
VOICU	ADRIANA	JudecatoriaRACARI
CORDESCU	RAMONA	JudecatoriaMORENI
DUMITRA	CONSTANTIN - DANIEL	JudecatoriaMORENI
MĂNESCU	VIOREL	JudecatoriaMORENI
NAE	VERONICA	JudecatoriaMORENI
ROBESCU	ROXANA MIHAELA	JudecatoriaMORENI
SULTANA	MANUEL  - REMI	JudecatoriaMORENI
ALBU	ILEANA	TribunalulPRAHOVA
ALEXANDRU	NICOLETA	TribunalulPRAHOVA
BOGHICI	ADRIANA MAGDALENA	TribunalulPRAHOVA
BOTNARU	IRINA HERMINA	TribunalulPRAHOVA
CĂLIN	NINETA	TribunalulPRAHOVA
CÎRCIOIU	MONICA	TribunalulPRAHOVA
CIOPONEA	IRINA - NICOLETA - ELISABETA	TribunalulPRAHOVA
DINU	IULIAN	TribunalulPRAHOVA
DUDUŞ	CARMEN MIHAELA	TribunalulPRAHOVA
ENACHE 	CRIASTIANA DANA	TribunalulPRAHOVA
FIRICEANU	GEANINA MARIA	TribunalulPRAHOVA
FLUTURAŞ	IULIANA MĂDĂLINA	TribunalulPRAHOVA
GHEORGHE	DANIELA	TribunalulPRAHOVA
GHINCEA	MARIUS	TribunalulPRAHOVA
HARHOI	ALICE GABRIELA	TribunalulPRAHOVA
IANA	OVIDIU	TribunalulPRAHOVA
IVAN-POPA	DANIELA	TribunalulPRAHOVA
LETEA	CRINA - MIHAELA	TribunalulPRAHOVA
LUPU	ANA MARIA	TribunalulPRAHOVA
MARIN	VIOREL	TribunalulPRAHOVA
MIHAI	GABRIELA	TribunalulPRAHOVA
MIHĂILESCU	CARMEN ANDRA	TribunalulPRAHOVA
MALIŢA	MIRELA	TribunalulPRAHOVA
NEGOTEI	LILIANA ASPASIA	TribunalulPRAHOVA
NICOLAE 	MARIANA	TribunalulPRAHOVA
NIŢĂ	CONSTANTIN	TribunalulPRAHOVA
PAŞCA	MIHAELA	TribunalulPRAHOVA
PAVEL ANTON	IONELA ALINA	TribunalulPRAHOVA
PODEA	PETRE-ADRIAN	TribunalulPRAHOVA
POPESCU 	AURA DANIELA	TribunalulPRAHOVA
RADU	MIHAIL	TribunalulPRAHOVA
ROMAN	CRISTINA	TribunalulPRAHOVA
RUŞAN	CHRISTIANA - MICHAELA - FRAGA	TribunalulPRAHOVA
SAVU 	ALINA - CRISTINA	TribunalulPRAHOVA
ŞOLOGON	OLIVIU CORNELIU	TribunalulPRAHOVA
ŞTEFUC	LILIANA	TribunalulPRAHOVA
TRANDAFIRESCU	ZINICA	TribunalulPRAHOVA
ALEXANDRU	VASILE	JudecatoriaPLOIESTI
ALEXE	GEORGE	JudecatoriaPLOIESTI
BALACI	MARIANA - ROXANA	JudecatoriaPLOIESTI
BĂLĂNOIU	PAUL	JudecatoriaPLOIESTI
BUGEAC	CRISTINA MAGDALENA	JudecatoriaPLOIESTI
BULIGA	IOANA	JudecatoriaPLOIESTI
BUNĂIAŞU	MIHAELA	JudecatoriaPLOIESTI
CHELARU	CRISTINA	JudecatoriaPLOIESTI
CÎMPEANU	ELISA ANA-MARIA	JudecatoriaPLOIESTI
COBÎSCAN	ALEXANDRU	JudecatoriaPLOIESTI
CRUCERU	CĂTĂLINA	JudecatoriaPLOIESTI
DÎRVARU	SERGIU IONUŢ	JudecatoriaPLOIESTI
DUICĂ	SIMONA - ANCA	JudecatoriaPLOIESTI
DUMITRU	FLORICA - IULIA	JudecatoriaPLOIESTI
FILIONESCU	ROBERT NICOLAE	JudecatoriaPLOIESTI
GHEORGHE	ANDREIA GEORGIANA	JudecatoriaPLOIESTI
ILIESCU	ANCA	JudecatoriaPLOIESTI
ION	ALEXANDRA	JudecatoriaPLOIESTI
IORGUŢĂ	GEORGIANA DOINA	JudecatoriaPLOIESTI
MARIN	MARIAN ROBERT	JudecatoriaPLOIESTI
MIHAIL	DRAGOŞ MIHAIL	JudecatoriaPLOIESTI
MITROI 	ALINA	JudecatoriaPLOIESTI
MIU	LAVINIA NUŞA	JudecatoriaPLOIESTI
NICULAE	GEORGIANA DANIELA	JudecatoriaPLOIESTI
PĂUN	ANDREI AUREL	JudecatoriaPLOIESTI
PENA	ANCA MARIA	JudecatoriaPLOIESTI
PETRU	MIRUNA - ELENA	JudecatoriaPLOIESTI
POPESCU	ELENA ROXANA	JudecatoriaPLOIESTI
RADU	CRISTINA	JudecatoriaPLOIESTI
STANCA	ANA MARIA	JudecatoriaPLOIESTI
STANCA	ZENOVIA	JudecatoriaPLOIESTI
SURDULEAC	VALERIA MARIA	JudecatoriaPLOIESTI
TRACHE	MONICA MARIA	JudecatoriaPLOIESTI
TUDORA	ANA	JudecatoriaPLOIESTI
VIOREL	GEORGEANA	JudecatoriaPLOIESTI
VIULEŢ	LILICA	JudecatoriaPLOIESTI
ZAMFIRESCU	ANCA - CORINA	JudecatoriaPLOIESTI
CERNICA	MARIA	JudecatoriaCAMPINA
CIMPOIAŞU-TANISLAV	CARMEN ANDREEA	JudecatoriaCAMPINA
DAVID	LUIGIA - IULIA	JudecatoriaCAMPINA
DULAMĂ	ELEONORA	JudecatoriaCAMPINA
ENESCU	MIHAELA LUMINIŢA	JudecatoriaCAMPINA
LALU	ALEXANDRA	JudecatoriaCAMPINA
MIHĂIESCU	JACLY	JudecatoriaCAMPINA
NEGOIAŞA	VIRGINIA	JudecatoriaCAMPINA
PETRE	MARIANA	JudecatoriaCAMPINA
ŞERBĂNESCU	MARILENA - ALINA	JudecatoriaCAMPINA
STĂNESCU	ELENA	JudecatoriaCAMPINA
TARASOV	SIMONA-ELENA	JudecatoriaCAMPINA
TOMESCU	ANDREIA - CLAUDIA - ALICE	JudecatoriaCAMPINA
ANGHEL	MONICA	JudecatoriaVALENIIDEMUNTE
BĂLAN 	DĂNUŢ - CRISTIAN	JudecatoriaVALENIIDEMUNTE
DINU	BIANCA	JudecatoriaVALENIIDEMUNTE
DRAGOMIR GALAN	CRISTINA IOANA	JudecatoriaVALENIIDEMUNTE
EŞANU	LILICA	JudecatoriaVALENIIDEMUNTE
JICA	ANTONELA ALIS	JudecatoriaVALENIIDEMUNTE
VOINEA	TRAIAN	JudecatoriaVALENIIDEMUNTE
DINU	MĂDĂLINA - GEORGETA	JudecatoriaMIZIL
FLOREA	LĂCRIMIOARA NICOLETA	JudecatoriaMIZIL
LAZĂR	MARIUS	JudecatoriaMIZIL
POPESCU	ANGHELINA	JudecatoriaMIZIL
POPESCU	CRINA	JudecatoriaMIZIL
POSTELNICU	ION	JudecatoriaMIZIL
TUDOR	NICU	JudecatoriaMIZIL
MITRACHE	ANCUTA-MONICA	JudecatoriaSINAIA
NECULAE	DANA GABRIELA	JudecatoriaSINAIA
POPESCU	RUXANDRA	JudecatoriaSINAIA
ŞTEFAN - VIERU	MARINELA	JudecatoriaSINAIA
ACSINTE	VIORICA	CurteadeApelSUCEAVA
ANDRIEŞ	CATRINEL-GIANINA	CurteadeApelSUCEAVA
ANDRIEŞ	MARIA	CurteadeApelSUCEAVA
ANDROHOVICI	DANIELA	CurteadeApelSUCEAVA
ANDRONIC	TATIANA LUISA	CurteadeApelSUCEAVA
ANTON	ŞTEFANIA-FULGA	CurteadeApelSUCEAVA
APARASCHIVEI	ADRIAN VALENTIN	CurteadeApelSUCEAVA
APOSTOL-IORDĂCHIOAIA	IONUŢ	CurteadeApelSUCEAVA
ARTENE	DOINA	CurteadeApelSUCEAVA
BICIUŞCĂ	OVIDIU	CurteadeApelSUCEAVA
BRATU	ILEANA	CurteadeApelSUCEAVA
CIUTĂ	OANA-ELENA	CurteadeApelSUCEAVA
CIUTĂ	EUGENIA	CurteadeApelSUCEAVA
COŞMAN	GHEORGHINA	CurteadeApelSUCEAVA
DUMITRAŞ	DANIELA	CurteadeApelSUCEAVA
DUMITRESCU	IULIUS CEZAR	CurteadeApelSUCEAVA
FLORARIU	GABRIEL IULIAN	CurteadeApelSUCEAVA
FRUNZĂ	SANDA	CurteadeApelSUCEAVA
GALAN	MARIUS IONEL	CurteadeApelSUCEAVA
GHERTNER	IOAN -ARTUR	CurteadeApelSUCEAVA
GRAPINI	CARMEN MARIA	CurteadeApelSUCEAVA
GROSU	CRISTINEL	CurteadeApelSUCEAVA
HETRIUC	LAURENŢIU MARIUS	CurteadeApelSUCEAVA
ILIEŞ	TITIANA	CurteadeApelSUCEAVA
MAIEREAN	ANA	CurteadeApelSUCEAVA
MARCU	MARIA-CĂTĂLINA	CurteadeApelSUCEAVA
MIHALCIUC	GETA-LILIOARA	CurteadeApelSUCEAVA
MITREA- MUNTEAN	ROZMENI-DANIELA	CurteadeApelSUCEAVA
NASTASI	DORINA	CurteadeApelSUCEAVA
NECHIFOR	VETA	CurteadeApelSUCEAVA
PLACINTĂ	DOCHIŢA	CurteadeApelSUCEAVA
RAŢĂ	GABRIELA-MARIANA	CurteadeApelSUCEAVA
SAS	LAURA ELISABETA	CurteadeApelSUCEAVA
SAS	REMUS VASILE	CurteadeApelSUCEAVA
STĂNESCU	AMALIA LAURA DANIELA	CurteadeApelSUCEAVA
SURDU	ADINA-OANA	CurteadeApelSUCEAVA
TIMOFTE	CRISTINA -MARIANA	CurteadeApelSUCEAVA
TEMNEANU	GHEORGHE CĂTĂLIN	CurteadeApelSUCEAVA
TOPALEA	KALINCA	CurteadeApelSUCEAVA
TURCULEŢ	ANA MARIA	CurteadeApelSUCEAVA
VINŢILĂ	NARCISA	CurteadeApelSUCEAVA
AIONESEI	DANIELA	TribunalulBOTOSANI
ANICULĂESEI	CRISTINA	TribunalulBOTOSANI
AROŞCULESEI	MARIA	TribunalulBOTOSANI
AXINTE	LĂCRĂMIOARA	TribunalulBOTOSANI
BURLACU	GEORGICĂ	TribunalulBOTOSANI
CONDURACHE	CLOPOŢEL MIHAI	TribunalulBOTOSANI
COTOI	FLORIN GHEORGHE	TribunalulBOTOSANI
DICU	AUREL LIVIU	TribunalulBOTOSANI
DICU	MARIA	TribunalulBOTOSANI
GHERCĂ	MIHAI	TribunalulBOTOSANI
GONTARIU	CONSTANTIN	TribunalulBOTOSANI
HANACHIUC 	GINA ALINA	TribunalulBOTOSANI
HERGHILIGIU	ANITTA MARIA	TribunalulBOTOSANI
HRUŞCĂ	IRINA	TribunalulBOTOSANI
LĂZĂRUC	LUMINIŢA - FLORICA	TribunalulBOTOSANI
PETROVICI	IOANA	TribunalulBOTOSANI
POPOVICI	MONICA MIHAELA	TribunalulBOTOSANI
PRUTEANU	LICĂ	TribunalulBOTOSANI
RĂCNEA	MIHAELA	TribunalulBOTOSANI
SMOCHINĂ	DAVID	TribunalulBOTOSANI
TIMOFTE	NADIA	TribunalulBOTOSANI
TOPORĂSCU	LILIOARA	TribunalulBOTOSANI
ŢURCANU	DORICA	TribunalulBOTOSANI
UNGUREANU	MIHAELA	TribunalulBOTOSANI
ADIMI	EMANUELA	JudecatoriaBOTOSANI
APOSTU 	ADINA	JudecatoriaBOTOSANI
AVIERIŢEI	VERONICA	JudecatoriaBOTOSANI
BILAN	PAUL	JudecatoriaBOTOSANI
BOICU	LENUŢA - LOREDANA	JudecatoriaBOTOSANI
BOSOC	SAMIR	JudecatoriaBOTOSANI
BRÂNZAC	LUCIAN IONUŢ	JudecatoriaBOTOSANI
BUHA	NICOLETA ELENA	JudecatoriaBOTOSANI
CEICĂ	LIVIU	JudecatoriaBOTOSANI
CORDUNEANU	ANAMARIA	JudecatoriaBOTOSANI
FURNICĂ	SILVIA	JudecatoriaBOTOSANI
HLIHOR	FILOTEIA	JudecatoriaBOTOSANI
HOLBOCIANU	CLAUDIU ADRIAN	JudecatoriaBOTOSANI
ILIE	MĂRIOARA	JudecatoriaBOTOSANI
MAXIM	ROXANA - RALUCA	JudecatoriaBOTOSANI
MIHALACHE	MIHAELA	JudecatoriaBOTOSANI
MIRON	CONSTANTIN CIPRIAN	JudecatoriaBOTOSANI
MURARIU	ADRIAN - VASILE	JudecatoriaBOTOSANI
NECULAI	MARIA IRINA	JudecatoriaBOTOSANI
PALANCANU	ALINA MIHAELA	JudecatoriaBOTOSANI
PERJU	ANDREEA	JudecatoriaBOTOSANI
POELINCĂ	LILIANA - SÂNDUŢA	JudecatoriaBOTOSANI
SAPARIUC	IRINEL	JudecatoriaBOTOSANI
TEODORU	CARMEN NICOLETA	JudecatoriaBOTOSANI
TINCU	ELENA-DIANA	JudecatoriaBOTOSANI
TODIREANU	CRISTINA	JudecatoriaBOTOSANI
VERCIUC	FLORIN	JudecatoriaBOTOSANI
VIERU	OANA  MIHAELA	JudecatoriaBOTOSANI
ABDULBAKI	ELENA CARMEN	JudecatoriaDOROHOI
COŞMAN	NECULAI - CRISTIAN	JudecatoriaDOROHOI
MURĂRAŞU	IOAN	JudecatoriaDOROHOI
NICOLAU	MARIUS - IONEL	JudecatoriaDOROHOI
NUME	PRENUME	
COZMEI	DANIELA	JudecatoriaSAVENI
LEMNARU	ANCA - LUCIANA	JudecatoriaSAVENI
MUSTEAŢĂ	CĂTĂLIN GABRIEL	JudecatoriaSAVENI
BUCULEI	ALEXANDRA - TEODORA	JudecatoriaDarabani
ILĂU	MIHAI	JudecatoriaDarabani
MAGA	MIHAELA DORINA	JudecatoriaDarabani
MARDAR	GEORGEL-TEOFIL	JudecatoriaDarabani
AIFTINCĂ	COSTEL	TribunalulSUCEAVA
APOSTOL IORDĂCHIOAIA	MARIA	TribunalulSUCEAVA
BĂLAN	CONSTANTIN	TribunalulSUCEAVA
BIVOL	MIHAELA	TribunalulSUCEAVA
BRĂDĂŢEANU	IOANA ECATERINA	TribunalulSUCEAVA
BRUMĂ	IULIANA DOINA	TribunalulSUCEAVA
BUNDUC	IOAN -DORU	TribunalulSUCEAVA
CODĂU	MINA - NADIA	TribunalulSUCEAVA
CODREAN	GHEORGHE	TribunalulSUCEAVA
COJOCARIU - ŞCHIOPU	DEMETRIAD	TribunalulSUCEAVA
CONDROVICI	LILIANA	TribunalulSUCEAVA
CRĂCIUN	GINA - IONELA	TribunalulSUCEAVA
DARAGIU	DELIA	TribunalulSUCEAVA
DĂNILĂ	CRISTINA DANIELA	TribunalulSUCEAVA
FROICU	LUMINIŢA	TribunalulSUCEAVA
GRAPINI	FLORINA FLAVIA	TribunalulSUCEAVA
GRIGOREAN	MARIA LOREDANA	TribunalulSUCEAVA
GRIGOREAN	DIANA	TribunalulSUCEAVA
HUŢULEAC 	LAVINIA	TribunalulSUCEAVA
IGNAT	MĂRIOARA	TribunalulSUCEAVA
ILAŞ	GEORGETA	TribunalulSUCEAVA
LOGIGAN	ANCA	TribunalulSUCEAVA
MAFTEI	CĂTĂLINA	TribunalulSUCEAVA
MITITELU	MARICICA	TribunalulSUCEAVA
MITRIC	LAURA IULIANA	TribunalulSUCEAVA
MURARIU	AURA-FLORENTINA	TribunalulSUCEAVA
NEAGU	DORIN	TribunalulSUCEAVA
NICOARĂ	DORINA CRISTINA	TribunalulSUCEAVA
ONCIULEANU	GABRIELA	TribunalulSUCEAVA
ONOFREICIUC DRANCA	GHEORGHE	TribunalulSUCEAVA
PIPERNEA	OANA	TribunalulSUCEAVA
POSTEUCĂ 	IOANA LOREDANA	TribunalulSUCEAVA
PLEŞCA	CRISTINA	TribunalulSUCEAVA
PUHA	CRISTINA DIANA	TribunalulSUCEAVA
SESERMAN	AURICA	TribunalulSUCEAVA
TEODORESCU	MARIANA	TribunalulSUCEAVA
VICTORIA	OANA-DANIELA	TribunalulSUCEAVA
VIZITIU	ELENA LAURA	TribunalulSUCEAVA
ZAHARIA	CORINA-MARIANA	TribunalulSUCEAVA
ANEI	CRISTINA	JudecatoriaSUCEAVA
ASIMINEI	ALEXANDRU	JudecatoriaSUCEAVA
BODNAR	LUIZA MARIA	JudecatoriaSUCEAVA
BRÂNZĂ	CĂTĂLIN	JudecatoriaSUCEAVA
CARAIMAN	IOANA	JudecatoriaSUCEAVA
CAZACU	ANCA	JudecatoriaSUCEAVA
CIOLAC	ANCA	JudecatoriaSUCEAVA
CORDUNEANU 	DANIEL	JudecatoriaSUCEAVA
COSOVĂŢ	ANDREI	JudecatoriaSUCEAVA
FOIT	MIOARA	JudecatoriaSUCEAVA
HOLBOCIANU	ELENA DELIA	JudecatoriaSUCEAVA
LOGIGAN	CIPRIAN ŞTEFAN	JudecatoriaSUCEAVA
LULCIUC	IULIA GABRIELA	JudecatoriaSUCEAVA
MANOLE	EMANUELA	JudecatoriaSUCEAVA
MOLIE	CĂTĂLINA	JudecatoriaSUCEAVA
NECHITA	MARICEL	JudecatoriaSUCEAVA
SIMIONESCU	GABRIEL ADRIAN	JudecatoriaSUCEAVA
ŞTEFAN	GEORGIANA LIVIA	JudecatoriaSUCEAVA
TĂUTU 	GEANINA	JudecatoriaSUCEAVA
TIMIŢĂ 	OANA ELENA	JudecatoriaSUCEAVA
TURCU	RODICA	JudecatoriaSUCEAVA
BEDRULE	GHEORGHE	JudecatoriaCAMPULUNGMOLDOVENESC
MERCHEŞ	DOINA	JudecatoriaCAMPULUNGMOLDOVENESC
MIHOC	MARIA	JudecatoriaCAMPULUNGMOLDOVENESC
POP	ANCA - ALICE	JudecatoriaCAMPULUNGMOLDOVENESC
VĂTĂMĂNESCU	LUCICA	JudecatoriaCAMPULUNGMOLDOVENESC
BĂRBUŢĂ	BOGDAN ILARION COSTICĂ	JudecatoriaRADAUTI
CIOBÎCĂ	GEORGE OCTAVIAN	JudecatoriaRADAUTI
COŞOVANU	MIHAI	JudecatoriaRADAUTI
GHINGHILOSCHI	RACHILA	JudecatoriaRADAUTI
POSTELNICU	GABRIELA	JudecatoriaRADAUTI
PRANDEA	DANIELA - MARIANA	JudecatoriaRADAUTI
SÎRGHI	GABRIEL MARIUS	JudecatoriaRADAUTI
TĂRÎŢĂ	CONSTANTIN	JudecatoriaRADAUTI
URSULIAC	MIHAELA	JudecatoriaRADAUTI
VĂCĂREANU	LAVINIA	JudecatoriaRADAUTI
VICOL	CRISTIAN	JudecatoriaRADAUTI
VICOL	GABRIELA	JudecatoriaRADAUTI
APOPI	ILEANA	JudecatoriaFALTICENI
COŞOREANU	SERGIU	JudecatoriaFALTICENI
DIEAC	EMANUELA GABRIELA	JudecatoriaFALTICENI
GHIDUC	IRINA MARIA	JudecatoriaFALTICENI
PASCARIU	MARIA	JudecatoriaFALTICENI
RUSU	MARIA	JudecatoriaFALTICENI
SĂRMĂŞANU	GEORGETA	JudecatoriaFALTICENI
ŞEPELEA	NICOLAE	JudecatoriaFALTICENI
HARITON	DANIELA - LOREDANA	JudecatoriaVATRADORNEI
MARIAN	FELICIA	JudecatoriaVATRADORNEI
UNGUREANU	CRISTIAN	JudecatoriaVATRADORNEI
BABOI	GHERASIM	JudecatoriaGURAHUMORULUI
MANDICI	OLGA	JudecatoriaGURAHUMORULUI
MOROŞAN 	CARMEN	JudecatoriaGURAHUMORULUI
PANŢIRU	CORALIA	JudecatoriaGURAHUMORULUI
SOCOLIUC	ELENA	JudecatoriaGURAHUMORULUI
ŞALAR	ALEXANDRU - IULIAN	JudecatoriaGURAHUMORULUI
BACIU	MONA-MAGDALENA	CurteadeApelTARGUMURES
BALAN	IULIAN CONSTANTIN	CurteadeApelTARGUMURES
BOANCĂ IVAN	MARLENA	CurteadeApelTARGUMURES
BOGDAN	CRISTINA BEATRIX	CurteadeApelTARGUMURES
BOGUŞ	SLAVONIA	CurteadeApelTARGUMURES
CIUCĂ	ANDREEA	CurteadeApelTARGUMURES
CREŢU	MIHAELA RAMONA	CurteadeApelTARGUMURES
DIMA	CORNELIA ANA	CurteadeApelTARGUMURES
DIMA	FLORIN	CurteadeApelTARGUMURES
DUMBRAVĂ	NICOLAE HORAŢIU	CurteadeApelTARGUMURES
GÂRBULEŢ	IOAN	CurteadeApelTARGUMURES
GĂZDAC	FLOARE	CurteadeApelTARGUMURES
GHEORGHIU	LIANA GABRIELA	CurteadeApelTARGUMURES
GROSU	FLOAREA	CurteadeApelTARGUMURES
IONAŞ	NICOLAE GABRIEL	CurteadeApelTARGUMURES
MICU	RODICA	CurteadeApelTARGUMURES
MIHAI	CRISTINA	CurteadeApelTARGUMURES
MUREŞAN	CORINA IOANA	CurteadeApelTARGUMURES
MUREŞAN	SIMONA TEODORA	CurteadeApelTARGUMURES
OLTEANU	AUREL	CurteadeApelTARGUMURES
OLTEAN	GEORGETA	CurteadeApelTARGUMURES
PETRICU IUJA	MARCELA DOINA	CurteadeApelTARGUMURES
RUSU	CAMELIA	CurteadeApelTARGUMURES
SZATMARI	ILONA	CurteadeApelTARGUMURES
TANKA	ATTILA	CurteadeApelTARGUMURES
URSULESCU	DANIEL CRISTIAN	CurteadeApelTARGUMURES
VASIESCU	MIHAELA DORINA	CurteadeApelTARGUMURES
VELŢAN	AURORA LETIŢIA	CurteadeApelTARGUMURES
VINTILĂ	ADELA	CurteadeApelTARGUMURES
ANDONIE	ADRIANA MAGDA	TribunalulMURES
ANDRASI BEANU	ALINA	TribunalulMURES
BERECZKI	FRANCISC ADRIAN	TribunalulMURES
CHERTES	DANIELA ANCA	TribunalulMURES
DEACONESCU	SONIA	TribunalulMURES
DUMITRESCU	LAURA ADINA	TribunalulMURES
HURDUGACI	EMANUELA	TribunalulMURES
IOSOF	RADU	TribunalulMURES
LUCACI	IOANA DELIA	TribunalulMURES
LULEA	MARILENA	TribunalulMURES
MARCHIŞ	HORAŢIU CĂTĂLIN	TribunalulMURES
MIRCEA	PAUL	TribunalulMURES
MOLDOVAN	MIHAELA ELENA	TribunalulMURES
MUREŞAN	FLAVIUS GHEORGHE	TribunalulMURES
OANCEA	EMIL TEODOR	TribunalulMURES
OGREAN	VIRGIL IOAN	TribunalulMURES
ONEA	IOANA	TribunalulMURES
PAŞOL	CRISTINA	TribunalulMURES
PETKA	ERZSEBET	TribunalulMURES
RISTACHE	MARIA	TribunalulMURES
SALCUDEAN	CODRUŢA LENUŢA	TribunalulMURES
SZASZ	VERONICA	TribunalulMURES
SZASZ	ROBERT MIHAI	TribunalulMURES
SZOTS	LEHEL BARNA	TribunalulMURES
TOMA	ANDREEA	TribunalulMURES
TUNSU	ROBERT IULIAN	TribunalulMURES
BULIGA	IONELA SPERANŢA	TribunalulComercialMURES
BULIGA	NICU VALENTIN	TribunalulComercialMURES
FARKAS-HEGYI	PIROSKA	TribunalulComercialMURES
FĂGĂRĂŞAN	MARIANA	TribunalulComercialMURES
LUPAŞCU	FLORIN	TribunalulComercialMURES
MAIER	IOAN EUGEN	TribunalulComercialMURES
MANTA	TUDORIŢA	TribunalulComercialMURES
ROMAN	NATALIA FLOAREA	TribunalulComercialMURES
ŞANTA	MARINEL	TribunalulComercialMURES
ALBU	TEODORA	JudecatoriaTARGUMURES
ALEXA 	ALEXANDRU	JudecatoriaTARGUMURES
BERINDEAN	ADRIANA LOREDANA	JudecatoriaTARGUMURES
BINDER	CSILLA NOEMI	JudecatoriaTARGUMURES
CĂILEAN	ANDREEA CAROLINA	JudecatoriaTARGUMURES
CEUŞEAN	GABRIELA GHIZELA	JudecatoriaTARGUMURES
COJOCARIU	FLORINA DANIELA	JudecatoriaTARGUMURES
COZGAREA	BOGDAN - IONUŢ	JudecatoriaTARGUMURES
DUMITRESCU	DUMITRU PAUL	JudecatoriaTARGUMURES
DOBRIŢOIU	CRISTINA	JudecatoriaTARGUMURES
FIROIU	CARMEN ISABELA	JudecatoriaTARGUMURES
FOLTIŞ	ADINA IULIA	JudecatoriaTARGUMURES
GARABET	IULIANA	JudecatoriaTARGUMURES
GRAMA	MARIA - MAGDALENA	JudecatoriaTARGUMURES
NICOLAU	IOANA AURA	JudecatoriaTARGUMURES
PAVEL	IONUŢ	JudecatoriaTARGUMURES
PREDA	STELA	JudecatoriaTARGUMURES
RAŢĂ – ALEXANDRESCU	CARMEN - SALOMEE	JudecatoriaTARGUMURES
ROŞIU	SIMONA	JudecatoriaTARGUMURES
RUSU	RALUCA IOANA	JudecatoriaTARGUMURES
SĂLĂGEAN	MARIA DUMITRIŢA	JudecatoriaTARGUMURES
SESCU	ANDREEA - MIHAELA	JudecatoriaTARGUMURES
SIKO	LASZLO CSABA	JudecatoriaTARGUMURES
SIMION	OANA BEATRICE	JudecatoriaTARGUMURES
URSA	GABRIEL CRISTIAN	JudecatoriaTARGUMURES
TOMA	CLAUDIA	JudecatoriaTARGUMURES
ZĂBAVĂ	OANA MARIA	JudecatoriaTARGUMURES
AENOAEI	VASILE	JudecatoriaSIGHISOARA
BOŞOTEANU	GABRIELA	JudecatoriaSIGHISOARA
MISIRGIC	LILIANA	JudecatoriaSIGHISOARA
POP	CORNELIA	JudecatoriaSIGHISOARA
VOLANSCHI	DOINA MIHAELA	JudecatoriaSIGHISOARA
BADIU	GABRIELA	JudecatoriaREGHIN
DĂNĂILĂ	DAN	JudecatoriaREGHIN
GHIBAN	LUCIAN MIHAI	JudecatoriaREGHIN
HODOŞ	ALINA	JudecatoriaREGHIN
MORAR	ADRIAN	JudecatoriaREGHIN
RUSU	BIANCA CODRUŢA	JudecatoriaREGHIN
TĂTARU	IRINA DANIELA	JudecatoriaREGHIN
CIOBANU	RADU	JudecatoriaLUDUS
HAMBEŢIU	ANA MARIA CRISTINA	JudecatoriaLUDUS
MANGU	IOAN- FLORIN	JudecatoriaLUDUS
NEAMŢU	MARIA	JudecatoriaLUDUS
CIUREA	ANDREIA RODICA	JudecatoriaTARNAVENI
MĂRĂSCU	DORINA	JudecatoriaTARNAVENI
RUS	ALIN - MARINEL	JudecatoriaTARNAVENI
TĂNASE	VALENTIN	JudecatoriaTARNAVENI
AIRINEI	IOANA	TribunalulHARGHITA
BANYAI	ENIKO	TribunalulHARGHITA
CODREANU	ANCA	TribunalulHARGHITA
COSOSCHI	SONIA	TribunalulHARGHITA
JURCĂ	BOGDAN RADU	TribunalulHARGHITA
LORINCZ	ROMEO	TribunalulHARGHITA
MANCIU	PAUL	TribunalulHARGHITA
MITREA	IBOLYA	TribunalulHARGHITA
SZIKSZAI	ENIKO	TribunalulHARGHITA
UŢĂ	ELENA-STELUŢA	TribunalulHARGHITA
UŢĂ	IOAN CRISTIAN	TribunalulHARGHITA
BEREKMERI-ERDELY	BEATA	JudecatoriaMIERCUREACIUC
BUTARU	CIPRIAN - GABRIEL	JudecatoriaMIERCUREACIUC
CSORYA	ILDIKO MĂRGĂRIT	JudecatoriaMIERCUREACIUC
DOBRIŢOIU	BOGDAN	JudecatoriaMIERCUREACIUC
GUŢIC	DANIEL VIOREL	JudecatoriaMIERCUREACIUC
MANOLI	LUCIAN	JudecatoriaMIERCUREACIUC
PĂCURAR	CRISTINA	JudecatoriaMIERCUREACIUC
PETER 	ANTAL LEVENTE	JudecatoriaMIERCUREACIUC
RUSSU	ADRIAN DORU	JudecatoriaMIERCUREACIUC
SEVESCU	GABRIELA VICTORIŢA	JudecatoriaMIERCUREACIUC
TUDOR	AURA MĂDĂLINA	JudecatoriaMIERCUREACIUC
BESENYEI	CSILLA IZABELLA	JudecatoriaODORHEIULSECUIESC
CIOBANU	ANA - MARIA	JudecatoriaODORHEIULSECUIESC
ILYES	IBOLYA	JudecatoriaODORHEIULSECUIESC
MĂLĂIEŞIU	GABRIELA RAMONA	JudecatoriaODORHEIULSECUIESC
REDAI	ZOLTAN JOSZEF	JudecatoriaODORHEIULSECUIESC
SZALLASY	MARIA MAGDOLNA	JudecatoriaODORHEIULSECUIESC
HANGANU	IOANA LUCIANA	JudecatoriaTOPLITA
ŢIFREA	ADRIANA	JudecatoriaTOPLITA
PARASCAN	VASILE ROMEO	JudecatoriaGHEORGHENI
PORTIK	IMRE	JudecatoriaGHEORGHENI
BARAC	LIDIA	CurteadeApelTIMISOARA
BACĂU	MARIA	CurteadeApelTIMISOARA
BIBEREA	MARIA -ANA	CurteadeApelTIMISOARA
BOGDAN	LAURA ANI	CurteadeApelTIMISOARA
BRATIS	MARIAN	CurteadeApelTIMISOARA
BUGARSKY	GHEORGHE	CurteadeApelTIMISOARA
BUTA	ANCA -CRISTINA	CurteadeApelTIMISOARA
CALAI	DANIELA RODICA	CurteadeApelTIMISOARA
CODREA	RUXANDRA GEORGETA	CurteadeApelTIMISOARA
COSTEA	CONSTANTIN	CurteadeApelTIMISOARA
CREŢU	MIRCEA	CurteadeApelTIMISOARA
DASCĂLU 	MARIA CORNELIA	CurteadeApelTIMISOARA
DICA	MARIA CRISTINA	CurteadeApelTIMISOARA
DOGARU	FLORIN	CurteadeApelTIMISOARA
DUMA	DIANA	CurteadeApelTIMISOARA
FLOREA	NELA ADELIA	CurteadeApelTIMISOARA
FLOREN’A	FLAVIA MARIA	CurteadeApelTIMISOARA
GAVRILESCU	MARIA OFELIA	CurteadeApelTIMISOARA
GIURGINCĂ	MARINELA	CurteadeApelTIMISOARA
IONESCU	FLAVIUS-ADELIN	CurteadeApelTIMISOARA
ISTRATE	MONICA	CurteadeApelTIMISOARA
JIVAN	IOAN NICOLAE	CurteadeApelTIMISOARA
LĂPĂDAT	LUCIAN	CurteadeApelTIMISOARA
LĂPĂDAT	MARIA	CurteadeApelTIMISOARA
LĂSCONI	DIANA 	CurteadeApelTIMISOARA
LUCACIUC	CAMELIA	CurteadeApelTIMISOARA
LUCACIUC	ŞTEFAN-IOAN	CurteadeApelTIMISOARA
MARTIN	CODRINA - IOSANA	CurteadeApelTIMISOARA
MICU	PETRUŢA	CurteadeApelTIMISOARA
MOŢIU	FLORIN -AUREL	CurteadeApelTIMISOARA
NACU	ANCA	CurteadeApelTIMISOARA
NASZ	CSABA BELA	CurteadeApelTIMISOARA
NICA	ANA MARIA	CurteadeApelTIMISOARA
NISTOR	ERICA	CurteadeApelTIMISOARA
OANA	CRISTIAN DANIEL	CurteadeApelTIMISOARA
OBERŞTERESCU	GHEORGHE	CurteadeApelTIMISOARA
OLARU	RODICA	CurteadeApelTIMISOARA
PANAITESCU	RALUCA ALEXANDRINA	CurteadeApelTIMISOARA
PĂTRU	RĂZVAN FLORIN	CurteadeApelTIMISOARA
PÂRVU	FLORENTINA	CurteadeApelTIMISOARA
PIRVULESCU	PUSA CARMEN	CurteadeApelTIMISOARA
POKKER	ADINA	CurteadeApelTIMISOARA
POPESCU	DUMITRU	CurteadeApelTIMISOARA
POPESCU	ŞTEFANIA EMANUELA	CurteadeApelTIMISOARA
PUP	CRISTIAN	CurteadeApelTIMISOARA
RAMBU	RUJIŢA	CurteadeApelTIMISOARA
ROHNEAN	CLAUDIA	CurteadeApelTIMISOARA
SANDOVICI 	VASILICA	CurteadeApelTIMISOARA
SCHNEPF	AURELIA ILEANA	CurteadeApelTIMISOARA
STOIAN 	ADRIAN ROMULUS	CurteadeApelTIMISOARA
ŞUIU	VIVI FLORIN	CurteadeApelTIMISOARA
ŢIROGA	ILIE DORIN	CurteadeApelTIMISOARA
VIŞOIU	DANA	CurteadeApelTIMISOARA
ACHIMESCU 	MIRELA DANIELA	TribunalulARAD
ALUNARU	CRISTIAN	TribunalulARAD
BAN	TATIANA -SORINA	TribunalulARAD
BĂILĂ	CARMEN CAMELIA	TribunalulARAD
BLIDAR	LAURA -IOANA	TribunalulARAD
BOŞCA -MATIŞ	CARMEN-NICOLETA	TribunalulARAD
CIACHIR	ADRIAN PETRU	TribunalulARAD
CIOARĂ	MARIANA	TribunalulARAD
COCOR	MAGDALENA CRISTINA	TribunalulARAD
COZMA	NICOLETA -ADINA	TribunalulARAD
DASCĂL	TEODOR	TribunalulARAD
DARĂU	IOAN TEODOR	TribunalulARAD
FOLTEAN	IOAN	TribunalulARAD
IOVĂNAŞ	EUGENIA	TribunalulARAD
JUNC	LIANA -ELENA	TribunalulARAD
LĂZĂRESCU	CAIUS VALERIAN	TribunalulARAD
MAGHERA	MIHAELA OANA	TribunalulARAD
MIHĂLAŞ	RAMONA CRISTINA	TribunalulARAD
MUNTEAN	DANIELA -CLAUDIA	TribunalulARAD
NĂDĂBAN	SILVIA	TribunalulARAD
OPREAN 	HOREA CORNELIU	TribunalulARAD
ŞERBAN	ANA	TribunalulARAD
ŞIANŢIU	CLAUDIU	TribunalulARAD
ŞTEF	LILIANA MARIANA	TribunalulARAD
ŞODINCA	SILVIUS-CRISTIAN	TribunalulARAD
ŞODINCĂ	LILIANA	TribunalulARAD
STANCU	CARMEN -LUCIA	TribunalulARAD
SZEP	SANDOR OTTO	TribunalulARAD
UNGUR	DĂNUŢ - CORNEL	TribunalulARAD
VINŢIELER	ŞTEFAN	TribunalulARAD
VLAD	FLORENTIN	TribunalulARAD
ARBONIE	RADU	JudecatoriaARAD
ATANASESCU	ANA MARIA	JudecatoriaARAD
BACHIOS 	ANDREEA DIANA	JudecatoriaARAD
BALAŞ	LUCIAN	JudecatoriaARAD
BÎSCĂ	ELENA DANIELA	JudecatoriaARAD
BOTEZATU-ZLATAN	HONORIU-ADRIAN	JudecatoriaARAD
BRADIN	VIRGILIU FLAVIUS	JudecatoriaARAD
BRANC 	COSMIN AURELIAN	JudecatoriaARAD
BUGARSKY	IVAN ENDRE	JudecatoriaARAD
CHILĂ	DOINA LILIANA	JudecatoriaARAD
CIOARĂ	MIHAELA	JudecatoriaARAD
CIUBAN	DOINA -LILIANA	JudecatoriaARAD
COŞOVEANU	RAMONA ADELA	JudecatoriaARAD
DEBRENI	CAMELIA LUCIA	JudecatoriaARAD
DEBRENI	CRISTIAN-DESIDERIU	JudecatoriaARAD
FIRCA	CRISTIAN EUGEN	JudecatoriaARAD
GUTTMANN	CRISTIAN - EUGEN	JudecatoriaARAD
HAŞ	CORINA	JudecatoriaARAD
MARTIN	RAUL - EMANUEL	JudecatoriaARAD
MIHALAŞ	CĂLIN CIPRIAN	JudecatoriaARAD
MIREA	CRISTIANA FLORINA	JudecatoriaARAD
NEAGU	ADRIAN	JudecatoriaARAD
OANA	ADINA	JudecatoriaARAD
PRECUP	NICOLETA -CARMEN	JudecatoriaARAD
STEPAN 	SMARANDA	JudecatoriaARAD
ŞURTEA	HORIA DOREL	JudecatoriaARAD
TIRITEU	DANIELA LUMINIŢA	JudecatoriaARAD
URZICEANU	LIVIU MIHAI	JudecatoriaARAD
VARGA	LORANT	JudecatoriaARAD
VINŢIELER	ADINA BOGDANA	JudecatoriaARAD
BOLOŞ	FLORIŢĂ	JudecatoriaINEU
LUCIU	MARIANA -NICOLETA	JudecatoriaINEU
PAŞCU 	VALENTIN MARIAN	JudecatoriaINEU
POPOVICIU	IOANA ANCUŢA	JudecatoriaINEU
TRIPA	AUREL ŞTEFAN	JudecatoriaINEU
DAMIAN	IOAN –TRAIAN	JudecatoriaLIPOVA
DOMILESCU	ION	JudecatoriaLIPOVA
POPESCU	EMILIAN –FLORIA	JudecatoriaLIPOVA
POPESCU	PETRU	JudecatoriaLIPOVA
ASLĂU 	ANCA	JudecatoriaGURAHONT
TRIF	GHEORGHE	JudecatoriaGURAHONT
FLOREA 	MARINEL DUMITRU	JudecatoriaCHISINEUCRIS
IUHOŞ	NICOLETA	JudecatoriaCHISINEUCRIS
AGHESCU	DORICA	TribunalulCARASSEVERIN
ALDEA	CORINA TITIANA	TribunalulCARASSEVERIN
BĂLĂUNŢESCU – VÎLCU	RODICA	TribunalulCARASSEVERIN
BEG – ENACHE	LUMINIŢA SIMONA	TribunalulCARASSEVERIN
BÎRSESCU	ROBERT- ALEXANDRU	TribunalulCARASSEVERIN
CHISEEV	ALIN –NARCIS	TribunalulCARASSEVERIN
CIASC	RUSTIN PETRU	TribunalulCARASSEVERIN
CIPU-DRĂGHICI	VALENTIN COSMIN	TribunalulCARASSEVERIN
COTOLAN	MARIA	TribunalulCARASSEVERIN
DETEŞAN	DANIELA	TribunalulCARASSEVERIN
IANCU	DANIELA –VALERIA	TribunalulCARASSEVERIN
ILIASĂ	MARIA	TribunalulCARASSEVERIN
IONESCU	TEODORA CORINA	TribunalulCARASSEVERIN
MĂGUREAN	MARIOARA-RODICA	TribunalulCARASSEVERIN
MALDEA	NICUŞOR	TribunalulCARASSEVERIN
MATUSCHKA	MONICA	TribunalulCARASSEVERIN
ROIESCU	CLAUDIA	TribunalulCARASSEVERIN
ROTARIU	LOREDANA MARIA	TribunalulCARASSEVERIN
STIUJ	VIVIANA	TribunalulCARASSEVERIN
STUPARU	MARIANA GABRIELA	TribunalulCARASSEVERIN
ŞUHANI	GABRIELA	TribunalulCARASSEVERIN
TELBIS	LUMINIŢA	TribunalulCARASSEVERIN
VEGHEŞ	ANA TEODORA	TribunalulCARASSEVERIN
BRONZ	MELINDA	JudecatoriaRESITA
CIUREA	IOANA CORINA	JudecatoriaRESITA
HODORCĂ	LUISA - FABIOLA	JudecatoriaRESITA
GRECU	RADU IULIAN	JudecatoriaRESITA
IVANCU	BEATRICE	JudecatoriaRESITA
JUCA	PETRU	JudecatoriaRESITA
PETRESCU	ILEANA LUMINIŢA	JudecatoriaRESITA
POP	IOANA LUCIANA	JudecatoriaRESITA
SĂRAC	MARIANA	JudecatoriaRESITA
AXENTI	ANA	JudecatoriaCARANSEBES
CALOIANU	DOINA	JudecatoriaCARANSEBES
GĂLESCU	DANIELA	JudecatoriaCARANSEBES
MIHUŢ	ALINA-DANIELA	JudecatoriaCARANSEBES
NEGOIŢĂ	LILIANA NICOLETA	JudecatoriaCARANSEBES
PUŞCAŞ	ADINA	JudecatoriaCARANSEBES
STAN	ELENA	JudecatoriaCARANSEBES
ZÎNCĂ	THEA ALEXANDRA	JudecatoriaCARANSEBES
GUGA	AURICĂ	JudecatoriaORAVITA
ROMAN	OVIDIU CĂLIN	JudecatoriaORAVITA
TEC	MIRCEA	JudecatoriaORAVITA
PASCARIU	RODICA	JudecatoriaORAVITA
POPUŢI	LUCIAN-MIHAI	JudecatoriaORAVITA
PRUNOIU 	ANCA	JudecatoriaMOLDOVANOUA
ANDREI	ANDRA	Tribunalul TIMIŞ
BĂDESCU	MONICA	Tribunalul TIMIŞ
BALABAN	GETA	Tribunalul TIMIŞ
BALCU	EUGENIA-CORINA	Tribunalul TIMIŞ
BĂRĂGAN	GABRIELA	Tribunalul TIMIŞ
BIRCEANU	TITU	Tribunalul TIMIŞ
BUŞCĂ	DIANA	Tribunalul TIMIŞ
BUŞCĂ	SERGIU	Tribunalul TIMIŞ
CERNUŞ	DUBRAVCA	Tribunalul TIMIŞ
CHIOREAN	MIHAI	Tribunalul TIMIŞ
CIUCUR	LUCIAN	Tribunalul TIMIŞ
CRĂCIUN	CRISTINA GINA	Tribunalul TIMIŞ
CRĂINICEANU	ALINA MIHAELA	Tribunalul TIMIŞ
DIDRAGA 	CRISTINA ANDRA	Tribunalul TIMIŞ
DOBRIN	LUCICA	Tribunalul TIMIŞ
DUMITRESCU	IOANA AMALIA	Tribunalul TIMIŞ
FETESCU	PETRU	Tribunalul TIMIŞ
HERCIU 	RADU HORIA	Tribunalul TIMIŞ
IOJA	ALEXANDRINA	Tribunalul TIMIŞ
IONESCU	IOANA-MIRELA	Tribunalul TIMIŞ
IOŢCOVICI	RAMONA LOREDANA	Tribunalul TIMIŞ
JEBELEAN	DANA	Tribunalul TIMIŞ
LUPŞA	SORINA	Tribunalul TIMIŞ
MATIAŞ	OLIMPIA MONICA	Tribunalul TIMIŞ
MIHEŢ-POPA	CORINA	Tribunalul TIMIŞ
NEAMŢU	LOREDANA	Tribunalul TIMIŞ
NEDA 	RALUCA OLIMPIA	Tribunalul TIMIŞ
PETRUŢA	ANA	Tribunalul TIMIŞ
POPESCU	IOAN	Tribunalul TIMIŞ
POPOVICI	CRISTINA	Tribunalul TIMIŞ
ROIBU	MIHAELA	Tribunalul TIMIŞ
ROTUNA	ALINA ŞTEFANIA	Tribunalul TIMIŞ
RUDĂREANU MIHANCEA	LAURA	Tribunalul TIMIŞ
SECULI	CASIANA –DELIA	Tribunalul TIMIŞ
SMÎNTÎNĂ	EDUARD	Tribunalul TIMIŞ
SPĂTARU	ADRIANA	Tribunalul TIMIŞ
STOICESCU 	ADRIANA PETRONELA	Tribunalul TIMIŞ
ŞOGOR 	LENUŢA	Tribunalul TIMIŞ
TALOŞ	IULIANA	Tribunalul TIMIŞ
ŢIRA	ANIŞOARA CORINA	Tribunalul TIMIŞ
TODOR 	MIRCEA LAZĂR	Tribunalul TIMIŞ
VERDEŞ	LUCIAN	Tribunalul TIMIŞ
VIDU	STELIAN-IOAN	Tribunalul TIMIŞ
ADAM	RALUCA	JudecatoriaTIMISOARA
AMAN	MARIA RODICA ANTOANELA	JudecatoriaTIMISOARA
AMZOI	ADELA ELISABETA	JudecatoriaTIMISOARA
ANASTASESCU	ANCA	JudecatoriaTIMISOARA
BALABAN	ANITA CRISTINA	JudecatoriaTIMISOARA
BĂLAN	MIHAI-ANDREI	JudecatoriaTIMISOARA
BĂLAN	MANUEL CIPRIAN	JudecatoriaTIMISOARA
BOGDANDI	ALEXANDRU ROBERT	JudecatoriaTIMISOARA
BORŢUN	MIHAELA DANIELA	JudecatoriaTIMISOARA
BORZA	RODICA	JudecatoriaTIMISOARA
BRATIŞ	ELENA LOREDANA	JudecatoriaTIMISOARA
BURDAN	ADINA – MONICA	JudecatoriaTIMISOARA
BURLACU	NICOLETA	JudecatoriaTIMISOARA
CARAVELEA	ŞTEFAN DORIN	JudecatoriaTIMISOARA
CEPEŞ	MIHAI	JudecatoriaTIMISOARA
CIOCŞIRESCU	MONICA IOANA	JudecatoriaTIMISOARA
COMAROMI	NICOLAE	JudecatoriaTIMISOARA
DIACONU	GABRIELA	JudecatoriaTIMISOARA
DIETRICH	MAGDALENA	JudecatoriaTIMISOARA
DIMITRIU	ADRIANA – LAURA	JudecatoriaTIMISOARA
DUMITRESCU	GABRIELA	JudecatoriaTIMISOARA
GLĂVAN	GIORGIANA ROXANA	JudecatoriaTIMISOARA
GODEAN	CAMELIA	JudecatoriaTIMISOARA
HANTEA	GIANINA-ANTOANELA	JudecatoriaTIMISOARA
HANTEA	DUMITRU	JudecatoriaTIMISOARA
ISAI	ANGELA	JudecatoriaTIMISOARA
JEBELEAN	MĂDĂLINA	JudecatoriaTIMISOARA
LAMBERT	AURELIA	JudecatoriaTIMISOARA
LUNGOCIA	CORNELIA –MARIA	JudecatoriaTIMISOARA
MARCU	DANIEL	JudecatoriaTIMISOARA
MARGAN	MARCELA DELIA	JudecatoriaTIMISOARA
MIHĂILESCU	ANDRA ALINA	JudecatoriaTIMISOARA
MORE  ZSIGMOND	GABRIELA	JudecatoriaTIMISOARA
NICA	CRISTIAN FELIX	JudecatoriaTIMISOARA
PIŢU	DANA	JudecatoriaTIMISOARA
POPESCU	NICOLETA	JudecatoriaTIMISOARA
POPEŢI	DANA	JudecatoriaTIMISOARA
PUIA	DANA -IOANA	JudecatoriaTIMISOARA
RADVANSKI	IZABELLA REKA	JudecatoriaTIMISOARA
ROMAN	LILIANA	JudecatoriaTIMISOARA
RISTEA	RAMONA	JudecatoriaTIMISOARA
SÎRBU	MONICA ELENA	JudecatoriaTIMISOARA
SÎRBU	TEODOR CĂLIN	JudecatoriaTIMISOARA
STĂICUŢ	IRINA ANDREEA	JudecatoriaTIMISOARA
ŞIPEŢAN	IONUŢ ADRIAN	JudecatoriaTIMISOARA
ŞORÂNDARU	ROXANA	JudecatoriaTIMISOARA
ŞTIRBAN	DIANA-PATRICIA	JudecatoriaTIMISOARA
TOMA	ADINA	JudecatoriaTIMISOARA
TOMICI	LAURA - MARIA	JudecatoriaTIMISOARA
TOMUŞ	NICOLAE-AURELIAN	JudecatoriaTIMISOARA
TUFIŞ	ROXANA	JudecatoriaTIMISOARA
BALACI-DUMA	MANUELA -CORINA	JudecatoriaLUGOJ
CORDOŞ	CARMELLA ROZALIA	JudecatoriaLUGOJ
COZILEC	IOAN	JudecatoriaLUGOJ
CREŢ	ALINA ADRIANA	JudecatoriaLUGOJ
CSORBA	LAURA FELICIA	JudecatoriaLUGOJ
MIHAI	SIMONA-MARIANA	JudecatoriaLUGOJ
PARFIN	EUGEN COSMIN	JudecatoriaLUGOJ
STERFENITU	FULVIA -ELISABETA	JudecatoriaLUGOJ
CHIRIAC-IENUŞ	LAVINIA -OLIVIA	JudecatoriaDETA
HERMAN	DANIEL IOAN	JudecatoriaDETA
MOISA	ALINA PARASCHIVA	JudecatoriaDETA
MOLNAR	CLAUDIA	JudecatoriaDETA
AVRAMESCU	SANDA OANA	JudecatoriaSANNICOLAULMARE
PÎRCĂLABĂBOIU	ADRIAN	JudecatoriaSANNICOLAULMARE
LĂZĂU	MIHAELA	JudecatoriaSANNICOLAULMARE
BLAGA	CRISTINA	JudecatoriaFAGET
JURJ	ANIŞOARA -LAURA	JudecatoriaFAGET
PERVU-MILOSTEAN	DIANA-EMANUELA	JudecatoriaFAGET
PUŞCAŞU	FLORINA MIHAELA	JudecatoriaFAGET
SCĂRLĂTESCU	OVIDIU – ŞTEFAN	JudecatoriaFAGET
ALEXANDRESCU	ANCA MĂDĂLINA	CurteadeApelBUCURESTI
ANCUŢA	ILEANA MIHAELA	CurteadeApelBUCURESTI
ANGHEL	DOINA	CurteadeApelBUCURESTI
ARBĂNAŞ	PETRICĂ	CurteadeApelBUCURESTI
ARJOCA	DANA-SIMONA	CurteadeApelBUCURESTI
AVRAM	AURICĂ	CurteadeApelBUCURESTI
BADEA	MIOARA	CurteadeApelBUCURESTI
BAJAN	ADRIANA - ELENA	CurteadeApelBUCURESTI
BAJAN	VASILE	CurteadeApelBUCURESTI
BĂLAN	CARMEN IOANA	CurteadeApelBUCURESTI
BARNA - PRISACARU	MIHAELA -IOANA	CurteadeApelBUCURESTI
BEJENAR	MELANIA	CurteadeApelBUCURESTI
BÎCU 	VASILE	CurteadeApelBUCURESTI
BÎNĂ	DANIELA ADRIANA	CurteadeApelBUCURESTI
BODEA	ADELA COSMINA	CurteadeApelBUCURESTI
BRĂTUIANU	ANTONELA CĂTĂLINA	CurteadeApelBUCURESTI
BUCULEI	ALINA PETRUŢA	CurteadeApelBUCURESTI
BULANCEA	DIANA MAGDALENA	CurteadeApelBUCURESTI
BURNEL	OANA	CurteadeApelBUCURESTI
BUZEA	IOANA	CurteadeApelBUCURESTI
CĂLIN	DRAGOŞ ALIN	CurteadeApelBUCURESTI
CANACHEU	CLAUDIA MARCELA	CurteadeApelBUCURESTI
CARPEN	RALUCA IOANA	CurteadeApelBUCURESTI
CEAUŞESCU	MARIA	CurteadeApelBUCURESTI
CIOATĂ 	ANDREEA	CurteadeApelBUCURESTI
CIOBANU 	CORINA	CurteadeApelBUCURESTI
CIOCEA	MIHAELA-LĂMÎIŢA	CurteadeApelBUCURESTI
CIOLCĂ 	MARILENA IULIANA	CurteadeApelBUCURESTI
CÎRJAN	RALUCA MARIA	CurteadeApelBUCURESTI
CÎRNARU	SIMONA ELENA	CurteadeApelBUCURESTI
CIRSTOIU	VERONICA	CurteadeApelBUCURESTI
CMECIU	ŞTEFAN CIPRIAN	CurteadeApelBUCURESTI
COMŞA	CARMEN-GEORGIANA	CurteadeApelBUCURESTI
CONSTANTIN 	NICOLETA IOANA	CurteadeApelBUCURESTI
CONSTANTINESCU F.	MARIANA	CurteadeApelBUCURESTI
CONSTANTINESCU M. 	MARIANA	CurteadeApelBUCURESTI
CONSTANTINESCU	CONSTANTIN LUCHIAN	CurteadeApelBUCURESTI
CORBOŞ	ADINA	CurteadeApelBUCURESTI
CORNEA	MARIA SPERANTA	CurteadeApelBUCURESTI
COSTACHE	ELENA RALUCA	CurteadeApelBUCURESTI
COSTINIU	VIORICA	CurteadeApelBUCURESTI
COTTA	FLORICA	CurteadeApelBUCURESTI
COTOROGEA	IONELA ALINA	CurteadeApelBUCURESTI
CRAIU	CRISTINA CARMEN	CurteadeApelBUCURESTI
CRAIU	IULIA	CurteadeApelBUCURESTI
CRINGASU	LILIANA	CurteadeApelBUCURESTI
CRISTEA	BOGDAN	CurteadeApelBUCURESTI
CRISTIU-NINU	LUMINITA	CurteadeApelBUCURESTI
CROITORU 	STELUŢA MIRELA	CurteadeApelBUCURESTI
DAVIDOIU	GEORGIAN	CurteadeApelBUCURESTI
DANCIU 	MIRELA	CurteadeApelBUCURESTI
DĂESCU	CORINA CORNELIA	CurteadeApelBUCURESTI
DĂNĂILĂ	ILEANA RUXANDRA	CurteadeApelBUCURESTI
DOBRANISTE	LIVIU-CORNEL	CurteadeApelBUCURESTI
DOLACHE 	DAMIAN	CurteadeApelBUCURESTI
DRAGAN	IONELIA	CurteadeApelBUCURESTI
DRĂGHICI	DANIEL MARIAN	CurteadeApelBUCURESTI
DUCA	MARIA VIOLETA	CurteadeApelBUCURESTI
DUMINECĂ	VIRGINIA FLORENTINA	CurteadeApelBUCURESTI
DUTA	FLORICĂ	CurteadeApelBUCURESTI
ENACHE 	DANIELA GEORGETA	CurteadeApelBUCURESTI
FARMATHY	AMELIA	CurteadeApelBUCURESTI
FARMATHY	GHEZA ATTILA	CurteadeApelBUCURESTI
FĂGET	LIVIU EUGEN	CurteadeApelBUCURESTI
FILIP	PAVEL	CurteadeApelBUCURESTI
FLOREA	DIANA 	CurteadeApelBUCURESTI
FLOREA	IONEL	CurteadeApelBUCURESTI
FLORESCU	GEORGE BOGDAN	CurteadeApelBUCURESTI
FLORESCU	CRISTINA MARIA	CurteadeApelBUCURESTI
FLORESCU	GABRIELA	CurteadeApelBUCURESTI
GAGESCU	RISANTEA	CurteadeApelBUCURESTI
GANU	ANA MARIA	CurteadeApelBUCURESTI
GĂINĂ	CARMEN VERONICA	CurteadeApelBUCURESTI
GĂINĂ	IONUŢ CRISTIAN	CurteadeApelBUCURESTI
GAVRIŞ	DUMITRU MARCEL	CurteadeApelBUCURESTI
GHICA	ALINA NICOLETA	CurteadeApelBUCURESTI
GHIŢĂ	CIPRIAN ALEXANDRU	CurteadeApelBUCURESTI
GLODEANU 	MIHAELA	CurteadeApelBUCURESTI
GLODEANU	ROMEO	CurteadeApelBUCURESTI
GRĂDINARU	DANIEL	CurteadeApelBUCURESTI
GRĂDINARU	IANINA BLANDIANA	CurteadeApelBUCURESTI
GRECEANU	ALESSANDRA -GIUSEPINA	CurteadeApelBUCURESTI
GRECU	GHEORGHE	CurteadeApelBUCURESTI
GRIGORE	DANIELA FLORELA	CurteadeApelBUCURESTI
GURANDA	GEORGETA	CurteadeApelBUCURESTI
GUŢĂ	CRISTINA	CurteadeApelBUCURESTI
HARABAGIU	LIZETA	CurteadeApelBUCURESTI
HORTOLOMEI	MARIANA	CurteadeApelBUCURESTI
HEROLD-PETRE	IOANA AURORA	CurteadeApelBUCURESTI
HOLBAN	MADALINA-IOANA	CurteadeApelBUCURESTI
HORTOLOMEI 	VICTOR	CurteadeApelBUCURESTI
IGNAT	SILVIA GEORGIANA	CurteadeApelBUCURESTI
ILEA	CĂTĂLINA GABRIELA	CurteadeApelBUCURESTI
ILIE	MARI	CurteadeApelBUCURESTI
ILIE	NADIA RALUCA	CurteadeApelBUCURESTI
ION-TUDORAN	CORNELIU BOGDAN	CurteadeApelBUCURESTI
IONIŢĂ	CRISTINA NICOLETA	CurteadeApelBUCURESTI
IORGULESCU	LILIANA	CurteadeApelBUCURESTI
IRIMIA	CRISTINA –MARIA	CurteadeApelBUCURESTI
ISPAS	MARIUS CRISTIAN	CurteadeApelBUCURESTI
IVĂNESCU	GABRIEL FLORIN	CurteadeApelBUCURESTI
JABRE	AMER	CurteadeApelBUCURESTI
LUDUŞAN	MANUELA	CurteadeApelBUCURESTI
LUPASCU	DAN	CurteadeApelBUCURESTI
MANOLE	DIANA	CurteadeApelBUCURESTI
MATEI	DOREL - GEORGE	CurteadeApelBUCURESTI
MĂIEREANU	IULIANA	CurteadeApelBUCURESTI
MEDIAN	ANCA MIHAELA	CurteadeApelBUCURESTI
MIHALCEA	DOINIŢA	CurteadeApelBUCURESTI
MIRANCEA	DUMITRU	CurteadeApelBUCURESTI
MÎNERAN	MIHAELA	CurteadeApelBUCURESTI
MORARU	DANIELA LAURA	CurteadeApelBUCURESTI
MOROŞANU	RALUCA	CurteadeApelBUCURESTI
MOŞNEAGU	ALINA PETRONELA	CurteadeApelBUCURESTI
MUSTATA	STAN	CurteadeApelBUCURESTI
NĂSTASIE	VERONICA	CurteadeApelBUCURESTI
NEACŞU	SIMONA GABRIELA	CurteadeApelBUCURESTI
NEDELCU	ANTONETA	CurteadeApelBUCURESTI
NEGOESCU GÂNDAC	MIHAI ANDREI	CurteadeApelBUCURESTI
NEGULESCU	CARMEN MIHAELA	CurteadeApelBUCURESTI
NICULESCU	MONICA	CurteadeApelBUCURESTI
NIEMESCH	OANA CRISTINA	CurteadeApelBUCURESTI
NIŢĂ	MIHAELA	CurteadeApelBUCURESTI
NIŢU	PETRONELA IULIA	CurteadeApelBUCURESTI
NOLDEN	NICOLETA	CurteadeApelBUCURESTI
OANCEA	MARIA DALINA	CurteadeApelBUCURESTI
OLTEANU	CRISTIAN	CurteadeApelBUCURESTI
OPRESCU	MIHAI	CurteadeApelBUCURESTI
OPRIS	ELENA DANIELA	CurteadeApelBUCURESTI
ORĂŞEANU	BOGDANA- ALINA	CurteadeApelBUCURESTI
PAVELESCU	SILVIA	CurteadeApelBUCURESTI
PĂNESCU	EUGENIA ALINA	CurteadeApelBUCURESTI
PANIOGLU	DANIELA	CurteadeApelBUCURESTI
PĂTRAŞ	BIANCA LAURA	CurteadeApelBUCURESTI
PATRASCU	HORATIU	CurteadeApelBUCURESTI
PENA	FĂNICA	CurteadeApelBUCURESTI
PERJARU	MIRELA MONICA	CurteadeApelBUCURESTI
PETRE	MAGDALENA	CurteadeApelBUCURESTI
PETROVICI	CRISTINA	CurteadeApelBUCURESTI
PICIARCA	DUMITRITA	CurteadeApelBUCURESTI
PODAR	VIOREL-ADRIAN	CurteadeApelBUCURESTI
PODARU	CORINA	CurteadeApelBUCURESTI
POGORAN	OANA DANIELA	CurteadeApelBUCURESTI
POHRIB	ALINA	CurteadeApelBUCURESTI
POP	ADRIANA-ROUA	CurteadeApelBUCURESTI
POPA	ION	CurteadeApelBUCURESTI
POPA 	ILEANA GABRIELA	CurteadeApelBUCURESTI
POPESCU	ADRIANA	CurteadeApelBUCURESTI
POPESCU	IULICA	CurteadeApelBUCURESTI
POPESCU	MARIANA	CurteadeApelBUCURESTI
PRELIPCEAN	IULIA- NICOLETA	CurteadeApelBUCURESTI
PRICOPE	PAUL	CurteadeApelBUCURESTI
RADOI	ELENA -SIMONA	CurteadeApelBUCURESTI
RADU	IONEL	CurteadeApelBUCURESTI
RADU	ADINA ADRIANA	CurteadeApelBUCURESTI
RĂDULESCU	MĂDĂLINA GABRIELA	CurteadeApelBUCURESTI
ROŞU 	ELISABETA	CurteadeApelBUCURESTI
ROŞU	PETRE	CurteadeApelBUCURESTI
ROTARU	FLORENTINA -GABRIELA	CurteadeApelBUCURESTI
SAVONEA	LIA	CurteadeApelBUCURESTI
SCHEAUA	MARIA CRISTINA	CurteadeApelBUCURESTI
SCROB	BIANCA ANTOANETA	CurteadeApelBUCURESTI
SEVERIN	DANIEL GHEORGHE	CurteadeApelBUCURESTI
SINGH	IOANA	CurteadeApelBUCURESTI
SÎRBU	GEORGETA	CurteadeApelBUCURESTI
SPÎNU	OVIDIU	CurteadeApelBUCURESTI
SPRÎNCEANĂ	CAMELIA MIOARA	CurteadeApelBUCURESTI
STAN	MONICA MIHAELA	CurteadeApelBUCURESTI
STAN	NICULAE	CurteadeApelBUCURESTI
STANCIU	ELENA MELANIA	CurteadeApelBUCURESTI
STATE UNGUREANU	ANA MARIA	CurteadeApelBUCURESTI
STEGARU	GEORGETA	CurteadeApelBUCURESTI
STOICA	LUMINIŢA CRISTINA	CurteadeApelBUCURESTI
STRÎMB	CODRUŢA	CurteadeApelBUCURESTI
SUCIU	RALUCA ALINA VIRGINIA	CurteadeApelBUCURESTI
ŞALAR	FELIX - LUCIAN	CurteadeApelBUCURESTI
ŞTEFAN	ALINA DIANA	CurteadeApelBUCURESTI
ŞUŢU	ALINA	CurteadeApelBUCURESTI
TARNA	SILVIA	CurteadeApelBUCURESTI
TOCAN	ISABELLE	CurteadeApelBUCURESTI
TOMA	CLAUDIU-MARIUS	CurteadeApelBUCURESTI
TOMESCU	ANDREEA DORIS	CurteadeApelBUCURESTI
TRĂMÎNDAN	CRINA BIANCA	CurteadeApelBUCURESTI
UDREA	ELENA LUISSA	CurteadeApelBUCURESTI
UNGUREANU	DOINA	CurteadeApelBUCURESTI
UTA	LUCIA	CurteadeApelBUCURESTI
UZLĂU	ANDREEA SIMONA	CurteadeApelBUCURESTI
VALAN	AGLAIA	CurteadeApelBUCURESTI
VASILE 	ANDREEA	CurteadeApelBUCURESTI
VADUVA	DUMITRU	CurteadeApelBUCURESTI
VINTANU	GABRIELA	CurteadeApelBUCURESTI
VINTILA	MIHAELA	CurteadeApelBUCURESTI
VIŞAN	DOINA	CurteadeApelBUCURESTI
VIŞOIU	EMILIA - CLAUDIA	CurteadeApelBUCURESTI
VLAD	DECEBAL CONSTANTIN	CurteadeApelBUCURESTI
VLAD	ELENA	CurteadeApelBUCURESTI
VLADU	RAMONA MARIA	CurteadeApelBUCURESTI
VOICAN	ANDREEA SILVIA	CurteadeApelBUCURESTI
VOINESCU	BOGDAN FLORIN	CurteadeApelBUCURESTI
ZAHARIA	ANAMARIA LUCIA	CurteadeApelBUCURESTI
ZECA	DORINA	CurteadeApelBUCURESTI
AFRĂSINIE	MĂDĂLINA	TribunalulBUCURESTI
ALBEANU	CLAUDIA -TITELA	TribunalulBUCURESTI
ALDEA	MIOARA	TribunalulBUCURESTI
ANDONE BONTAŞ	AMALIA	TribunalulBUCURESTI
ANDREI	CLAUDIU - IONUT	TribunalulBUCURESTI
ANDREI	LAURA -MARINA	TribunalulBUCURESTI
ANDRIESCU	VLAD	TribunalulBUCURESTI
ANDRIOAEI	CORNELIU LUCIAN	TribunalulBUCURESTI
ANTON	IOANA ANTONIA	TribunalulBUCURESTI
ARDELEANU 	CRISTINA	TribunalulBUCURESTI
ARIF	CARMEN MIHAELA	TribunalulBUCURESTI
ASĂNICĂ	ANDRA MONICA	TribunalulBUCURESTI
AVRIGEANU	ELENA	TribunalulBUCURESTI
AXÎNTI	CĂTĂLIN	TribunalulBUCURESTI
BADEA	MĂDĂLINA	TribunalulBUCURESTI
BALACI	CARMEN CONSTANŢA	TribunalulBUCURESTI
BĂDESCU	IRINA - RALUCA	TribunalulBUCURESTI
BĂDOIU	CĂTĂLIN- GABRIEL	TribunalulBUCURESTI
BĂDOIU	ENRICA -ANDA	TribunalulBUCURESTI
BĂLĂCEANU	LILIANA	TribunalulBUCURESTI
BĂLĂNESCU	MIHAI	TribunalulBUCURESTI
BĂLAN	IONICA	TribunalulBUCURESTI
BAN	MIORIŢA	TribunalulBUCURESTI
BĂRGAN	MIHAELA CLAUDIA	TribunalulBUCURESTI
BĂTRÂNU	NICOLETA	TribunalulBUCURESTI
BÎRLOG	ANDREEA MĂDĂLINA	TribunalulBUCURESTI
BELOIU	ALINA- DANIELA	TribunalulBUCURESTI
BIVOLARU	ŞTEFANIA IRINEL	TribunalulBUCURESTI
BOGATU	ELENA DANIELA	TribunalulBUCURESTI
BOGDAN	CAMELIA	TribunalulBUCURESTI
BOGDANESCU	MADALINA-MARIA	TribunalulBUCURESTI
BOJINCĂ	ELENA ADINA	TribunalulBUCURESTI
BOMBOŞ	ANA OTILIA	TribunalulBUCURESTI
BOSIE	LAURA NICOLETA	TribunalulBUCURESTI
BRATU	DANIELA CONSTANŢA	TribunalulBUCURESTI
BRATU	MARIA ADRIANA	TribunalulBUCURESTI
BUDALĂ	CRISTINA ANDREEA	TribunalulBUCURESTI
BUDULAN	ROXANA TĂSICA	TribunalulBUCURESTI
BULGARU	LAVINIA MAGDALENA	TribunalulBUCURESTI
BUMBULUT	ANCA STELA	TribunalulBUCURESTI
BURICEA	CRINA LILIANA	TribunalulBUCURESTI
BURLAN	ELENA	TribunalulBUCURESTI
BUŞCĂ	AMELIA RALUCA	TribunalulBUCURESTI
BURTESCU	AURORA MARIA	TribunalulBUCURESTI
CALCIU	LUMINIŢA	TribunalulBUCURESTI
CARAGAŢĂ	LUISA EMANUELA	TribunalulBUCURESTI
CĂLIN	ROXANA MARIA	TribunalulBUCURESTI
CĂLINESCU	DANIELA	TribunalulBUCURESTI
CĂZĂNESCU	MIRUNA IOANA	TribunalulBUCURESTI
CIOBOTARU	SORINA	TribunalulBUCURESTI
CIOBOTARU	EDUARD CRISTIAN	TribunalulBUCURESTI
CIPARIU	MONICA CLAUDIA	TribunalulBUCURESTI
CIUPERCĂ	LILIANA	TribunalulBUCURESTI
CÎRSTEA 	FLORINA IZABELA	TribunalulBUCURESTI
COMAN	ADELA	TribunalulBUCURESTI
COMAN 	CRISTINA DANIELA	TribunalulBUCURESTI
CONSTANTIN	GRATIELA-MONICA	TribunalulBUCURESTI
CONSTANTIN MARINO	MARIN	TribunalulBUCURESTI
CORBU	GEORGIANA CORINA	TribunalulBUCURESTI
CORNEA	ADINA	TribunalulBUCURESTI
COSMA	ADINA	TribunalulBUCURESTI
COSMA	CARMEN	TribunalulBUCURESTI
COSTACHE	ANTONELA ANE-MARY	TribunalulBUCURESTI
COŞĂREANU	ELENA DANIELA	TribunalulBUCURESTI
COZAN	RALUCA ELENA	TribunalulBUCURESTI
CRIŞAN	SOFIA SÂNZIANA	TribunalulBUCURESTI
CUCU	CRISTINA	TribunalulBUCURESTI
CUZUC	MIHAELA	TribunalulBUCURESTI
DIKO	DANIELA –MIHAELA	TribunalulBUCURESTI
DIMULESCU	GABRIELA	TribunalulBUCURESTI
DOGARIU	NICOLETA	TribunalulBUCURESTI
DONŢETE	DANIEL	TribunalulBUCURESTI
DRAGU	MIHAELA ALINA	TribunalulBUCURESTI
DRĂGUŢESCU	MIHAI  -PANTELIMON	TribunalulBUCURESTI
DUDU	DANIELA ANICA	TribunalulBUCURESTI
DULGHERU	EMANUELA	TribunalulBUCURESTI
DUMITRESCU	MARIA OANA	TribunalulBUCURESTI
DUŢU	LILIANA CĂTĂLINA	TribunalulBUCURESTI
ECXARCU - HARFAŞ	ANDREEA LAVINIA ERSILIA	TribunalulBUCURESTI
FARCAŞ ŞURPANU	CRISTINA	TribunalulBUCURESTI
FLOREA	CRISTINA MIHAELA	TribunalulBUCURESTI
FLORESCU	ELISABETA	TribunalulBUCURESTI
FRUNZĂ	LUCIA IOANA	TribunalulBUCURESTI
FULEA	IOANA VIOLETA	TribunalulBUCURESTI
GALEA	RALUCA ELENA	TribunalulBUCURESTI
GALIŞ	ADRIANA VERONICA	TribunalulBUCURESTI
GAROFIL 	ANA MARIA	TribunalulBUCURESTI
GAVREA	LONETA HONORINA	TribunalulBUCURESTI
GAVRIS	MARILENA- VERONICA	TribunalulBUCURESTI
GADI	LINDA IULIA	TribunalulBUCURESTI
GHEORGHE	BRINDUSA ELENA	TribunalulBUCURESTI
GHEORGHE	CARMEN LILIANA	TribunalulBUCURESTI
GHERGHEŞANU	PETRICĂ	TribunalulBUCURESTI
GHINDAR	LIDIA DANIELA	TribunalulBUCURESTI
GHITA	ECATERINA-LUCIA	TribunalulBUCURESTI
GHIUGAN	IONELA - MARIANA	TribunalulBUCURESTI
GIURCA	TEODORA	TribunalulBUCURESTI
GOHOREANU	CARMEN ALINA	TribunalulBUCURESTI
GONGONE	ANDREI FLORIN	TribunalulBUCURESTI
GRECU	RUXANDRA	TribunalulBUCURESTI
GROZESCU	AURELIA MIHAELA	TribunalulBUCURESTI
GURĂU	IONELA CLAUDIA	TribunalulBUCURESTI
GUTU	MANUELA AURORA	TribunalulBUCURESTI
HARAGA	CRISTIAN	TribunalulBUCURESTI
IACOB	CONSTANTINA -CORALIA	TribunalulBUCURESTI
IACOB	ELENA TEODORA	TribunalulBUCURESTI
IACOB	MARCELA MARTA	TribunalulBUCURESTI
ILIE	CAMELIA MARIA	TribunalulBUCURESTI
ILINA	CRISTINA	TribunalulBUCURESTI
ION	IONELA	TribunalulBUCURESTI
ION CHIRIŢĂ	LILIANA	TribunalulBUCURESTI
IONITA	PETRONELA	TribunalulBUCURESTI
JABRE	CECILIA	TribunalulBUCURESTI
JDERU	CLAUDIA	TribunalulBUCURESTI
LARION	IULIANA MĂDĂLINA	TribunalulBUCURESTI
LAZAR	DANIELA-ADRIANA	TribunalulBUCURESTI
LAZĂR 	FLORICA	TribunalulBUCURESTI
LUPU	MIRUNA - IULIA	TribunalulBUCURESTI
MALALIU	MIHAI-ANDI	TribunalulBUCURESTI
MANEA	CĂTĂLIN DĂNUŢ	TribunalulBUCURESTI
MANEA	IULIA-LACRAMIOARA	TribunalulBUCURESTI
MARASOIU	NICOLETA	TribunalulBUCURESTI
MARCU	ROZA	TribunalulBUCURESTI
MARINESCU	DANIELA IULIANA	TribunalulBUCURESTI
MATEESCU	ANA -MARIA	TribunalulBUCURESTI
MATEESCU	ANDREEA FLORINA	TribunalulBUCURESTI
MATEI 	VIORICA SIMONA	TribunalulBUCURESTI
MEAUCĂ	MIHAELA	TribunalulBUCURESTI
MIHAILESCU	STELIANA	TribunalulBUCURESTI
MIHEŢ	DARIA ISABELA	TribunalulBUCURESTI
MILITARU	IONUŢ	TribunalulBUCURESTI
MIREA	ECATERINA- MARIANA	TribunalulBUCURESTI
MLADIN GOLEA	MANUELA –CARMEN	TribunalulBUCURESTI
MOCANU	ELISABETA	TribunalulBUCURESTI
MOISE	ROBERT EUGEN	TribunalulBUCURESTI
MOISESCU	CONSTANTA	TribunalulBUCURESTI
MOLDOVAN	MIRCEA	TribunalulBUCURESTI
MONCEA	MARIANA	TribunalulBUCURESTI
MOSOR	ROXANA	TribunalulBUCURESTI
MUNTEANU	LIGIA RALUCA	TribunalulBUCURESTI
MURARIU 	DENISA	TribunalulBUCURESTI
NEACŞU 	GEORGETA MARILENA	TribunalulBUCURESTI
NEAGOE	MONA-LISA	TribunalulBUCURESTI
NEAGU	IRINA ALEXANDRA	TribunalulBUCURESTI
NESTOR	RAUL ALEXANDRU	TribunalulBUCURESTI
NICA	MONICA	TribunalulBUCURESTI
NICULAE	RODICA	TribunalulBUCURESTI
NINU	IONICA	TribunalulBUCURESTI
NITU	DANIELA  - LUMINITA	TribunalulBUCURESTI
NIŢU	DOINIŢA LUMINIŢA	TribunalulBUCURESTI
OPRIŢA	STELIANA	TribunalulBUCURESTI
PAICU	MIHAELA	TribunalulBUCURESTI
PALICI	GIANINA GEORGIANA	TribunalulBUCURESTI
PANAIT 	IULIAN	TribunalulBUCURESTI
PANAITE JITIANU	ELENA	TribunalulBUCURESTI
PARASCHIV	AURORA	TribunalulBUCURESTI
PARVU	IOSEFINA	TribunalulBUCURESTI
PAUN	SANDA	TribunalulBUCURESTI
PAVAL	CARMEN - IULIANA	TribunalulBUCURESTI
PĂUN	ELENA	TribunalulBUCURESTI
PETRESCU	PETRONELA SIMONA	TribunalulBUCURESTI
PETROVAN 	LILIANA	TribunalulBUCURESTI
PIRVU	MAGDALENA	TribunalulBUCURESTI
PÎSLARU	SIMONA MARICELA	TribunalulBUCURESTI
PLĂCINTĂ	MARIA DESPINA	TribunalulBUCURESTI
PLESA	LAURA ELENA	TribunalulBUCURESTI
POD	MIRELA	TribunalulBUCURESTI
POP	CAMELIA MARIA	TribunalulBUCURESTI
POPA	ELENA ANETA	TribunalulBUCURESTI
POPA	SEMIDA EMANUELA	TribunalulBUCURESTI
POPESCU	ALINA LOREDANA	TribunalulBUCURESTI
POPESCU	AIDA-OANA	TribunalulBUCURESTI
POPESCU	ALEXANDRU RĂZVAN GEORGE	TribunalulBUCURESTI
POPESCU 	ANDREEA MIHAELA	TribunalulBUCURESTI
POPESCU	RODICA	TribunalulBUCURESTI
POPESCU 	ANDREEA	TribunalulBUCURESTI
POPOIU	GEORGIANA ELENA	TribunalulBUCURESTI
PUŞCHIN	CORINA	TribunalulBUCURESTI
PREPELIŢĂ	NICOLAE	TribunalulBUCURESTI
PRILOGAN 	CLAUDIA FLORINA	TribunalulBUCURESTI
PRUJOIU	VERONICA-ELENA	TribunalulBUCURESTI
PURIGIU	FLORIN	TribunalulBUCURESTI
RADU	CRISTINA RALUCA	TribunalulBUCURESTI
RADU	MIHAELA- LAURA	TribunalulBUCURESTI
RADUCANU	ANDREEA	TribunalulBUCURESTI
RADUCU	OLIMPIA  LOUYSSE	TribunalulBUCURESTI
RAMAŞCANU	BEATRICE LENUŢA	TribunalulBUCURESTI
RICHIŢEANU	NĂSTASE OVIDIU	TribunalulBUCURESTI
RÎŞNOVEANU 	GABRIELA MIHAELA	TribunalulBUCURESTI
ROLEA	GABRIELA	TribunalulBUCURESTI
ROSU	ELENA	TribunalulBUCURESTI
ROVENTA	ELENA	TribunalulBUCURESTI
SANDU	GHEORGHITA	TribunalulBUCURESTI
SARU	ANCA	TribunalulBUCURESTI
SAVU	RODICA	TribunalulBUCURESTI
SAVIN 	VALENTIN	TribunalulBUCURESTI
SCUTELNICU	OANA ALINA	TribunalulBUCURESTI
SECAN	BOGDANA LIGIA	TribunalulBUCURESTI
SEGA	MARIUS-CONSTANTIN	TribunalulBUCURESTI
SEGĂRCEANU	DOINA	TribunalulBUCURESTI
SEVERIN	TATIANA LOREDANA	TribunalulBUCURESTI
SÎRBU	GABRIELA	TribunalulBUCURESTI
STAICU	IULIANA	TribunalulBUCURESTI
STANCIU	ION	TribunalulBUCURESTI
STANCU	MIRELA	TribunalulBUCURESTI
STANCIU	ROXANA	TribunalulBUCURESTI
STROE	ELIZA MAGDALENA	TribunalulBUCURESTI
ŞIPOTEANU	CLEOPATRA- IOANA	TribunalulBUCURESTI
STEGARU	MITU	TribunalulBUCURESTI
STĂNCESCU	MIHAELA	TribunalulBUCURESTI
ŢAMBULEA	ALINA GABRIELA	TribunalulBUCURESTI
TANASESCU	DANIELA-ILEANA	TribunalulBUCURESTI
TARTAU	IULIAN	TribunalulBUCURESTI
TÂRŢĂU	LUMINIŢA-SPERANŢA	TribunalulBUCURESTI
TELECHI	CORNELIA- MAGDALENA -BIANCA	TribunalulBUCURESTI
TERCEANU	GEANINA	TribunalulBUCURESTI
TERCEANU	VALERIU -MIHAIL	TribunalulBUCURESTI
THEOHARI	DELIA NARCISA	TribunalulBUCURESTI
TOADER	DANIELA	TribunalulBUCURESTI
TOMA	RALUCA ECATERINA	TribunalulBUCURESTI
TRANCĂ	ANA MARIA	TribunalulBUCURESTI
TRINCĂ	ALINA IRINA	TribunalulBUCURESTI
TUDOR	ANA CORINA	TribunalulBUCURESTI
TUINEA	ANCA - VALENTINA	TribunalulBUCURESTI
TUIU	STEFANIA	TribunalulBUCURESTI
UDANGIU	RĂZVAN VIOREL	TribunalulBUCURESTI
UDROIU	MIHAIL	TribunalulBUCURESTI
VĂCĂRUŞ	STANCU	TribunalulBUCURESTI
VASILACHE	MARIA AURELIA	TribunalulBUCURESTI
VASILATEANU	FLORENTINA	TribunalulBUCURESTI
VASILE CRISTEA	MIRELA SIMONA	TribunalulBUCURESTI
VASILESCU	SORIN MIREL	TribunalulBUCURESTI
VÎLCELEANU	CRISTINA NICOLETA	TribunalulBUCURESTI
VIŞAN	ALEXANDRA	TribunalulBUCURESTI
VIŞAN 	CRISTIAN ŞTEFAN	TribunalulBUCURESTI
VIŞOIU	SIMONA	TribunalulBUCURESTI
VIZIRU	CIPRIAN SORIN	TribunalulBUCURESTI
VOICULESCU	ANCA-MAGDA	TribunalulBUCURESTI
VOICA	VALERICA	TribunalulBUCURESTI
VOINA	VICTOR IONUŢ	TribunalulBUCURESTI
VRABIE	ELENA LIVIANA	TribunalulBUCURESTI
ZAMFIR	MARIA	TribunalulBUCURESTI
ZARAFIU	SIMONA MARIA	TribunalulBUCURESTI
ZGONDEA 	GHEORGHE TUDOREL	TribunalulBUCURESTI
ZIDARU	GHEORGHE LIVIU	TribunalulBUCURESTI
ADAM 	CONSTANTINA VERONICA	JudecatoriaSECTORUL1BUCURESTI
ALECSIU	OCTAVIA MARCELA	JudecatoriaSECTORUL1BUCURESTI
ALECU	ROXANA DELIA	JudecatoriaSECTORUL1BUCURESTI
AMBROZIE	SILVIA	JudecatoriaSECTORUL1BUCURESTI
ANCHIDIN	ANDREEA	JudecatoriaSECTORUL1BUCURESTI
ANGHELESCU	CARLA ALEXANDRA	JudecatoriaSECTORUL1BUCURESTI
BÎRSĂŞTEANU	RALUCA	JudecatoriaSECTORUL1BUCURESTI
BLIDARU MATEESCU	ELENA	JudecatoriaSECTORUL1BUCURESTI
BRATU	NICOLETA MONICA	JudecatoriaSECTORUL1BUCURESTI
BUŞULESCU	ANDREEA	JudecatoriaSECTORUL1BUCURESTI
CIOBANU	MIHAELA	JudecatoriaSECTORUL1BUCURESTI
CREŢEANU	OLIMPIEA	JudecatoriaSECTORUL1BUCURESTI
DECULESCU	DIANA	JudecatoriaSECTORUL1BUCURESTI
DICU	PETRE CRISTIAN	JudecatoriaSECTORUL1BUCURESTI
ENACHE	TEODORA ADRIANA	JudecatoriaSECTORUL1BUCURESTI
FOCŞA	RALUCA	JudecatoriaSECTORUL1BUCURESTI
GARABET	LOREDANA	JudecatoriaSECTORUL1BUCURESTI
GARGALE	ANASTASIA	JudecatoriaSECTORUL1BUCURESTI
GĂNII	RODICA	JudecatoriaSECTORUL1BUCURESTI
GHERASIM PROCA	VALENTINA	JudecatoriaSECTORUL1BUCURESTI
GHIŢĂ	CRISTINA NICOLETA	JudecatoriaSECTORUL1BUCURESTI
GIORGESCU	OVIDIU	JudecatoriaSECTORUL1BUCURESTI
GOGESCU	PARASCHIVA NINA	JudecatoriaSECTORUL1BUCURESTI
HLIHOR	IOANA CRISTINA	JudecatoriaSECTORUL1BUCURESTI
HUBERT	IOANA	JudecatoriaSECTORUL1BUCURESTI
IACOB	ELENA	JudecatoriaSECTORUL1BUCURESTI
IFRIM	STELIANA VALENTINA	JudecatoriaSECTORUL1BUCURESTI
ION	CĂTĂLIN DANIEL	JudecatoriaSECTORUL1BUCURESTI
ION	ROXANA IULIANA	JudecatoriaSECTORUL1BUCURESTI
IONESCU-LUPEANU	CRISTINA	JudecatoriaSECTORUL1BUCURESTI
MADULARESCU	EMILIA	JudecatoriaSECTORUL1BUCURESTI
MEIU	EMILIAN CONSTANTIN	JudecatoriaSECTORUL1BUCURESTI
MESTER	ANDREA	JudecatoriaSECTORUL1BUCURESTI
MOISE	LUIZA ECATERINA	JudecatoriaSECTORUL1BUCURESTI
NĂSTASE	ADRIAN	JudecatoriaSECTORUL1BUCURESTI
NEGROIU	REBECCA ZINCA	JudecatoriaSECTORUL1BUCURESTI
NEŢOIU	ELENA ANDREEA	JudecatoriaSECTORUL1BUCURESTI
OPĂRIUC	VIRGINIA	JudecatoriaSECTORUL1BUCURESTI
PANAIT	ALEXANDRA	JudecatoriaSECTORUL1BUCURESTI
PANAITESCU - ALEGRIA	CAMELIA	JudecatoriaSECTORUL1BUCURESTI
PĂCURAR	ADRIAN	JudecatoriaSECTORUL1BUCURESTI
PĂTRAŞCU	PAULA VASILICA	JudecatoriaSECTORUL1BUCURESTI
PĂDURARU	DANA PETRINA	JudecatoriaSECTORUL1BUCURESTI
PINTEA	ANDREEA - ALEXANDRA	JudecatoriaSECTORUL1BUCURESTI
PITULAC	FLORENTINA MIHAELA	JudecatoriaSECTORUL1BUCURESTI
POP	MONICA	JudecatoriaSECTORUL1BUCURESTI
POPA	MONICA	JudecatoriaSECTORUL1BUCURESTI
POPESCU	FLORINA ALINA	JudecatoriaSECTORUL1BUCURESTI
RADU	BIANCA ELENA	JudecatoriaSECTORUL1BUCURESTI
RESTEANU	EDUARDO	JudecatoriaSECTORUL1BUCURESTI
ROGOZ	RAMONA OANA	JudecatoriaSECTORUL1BUCURESTI
ROTARU	LIGIA	JudecatoriaSECTORUL1BUCURESTI
SANDU	IOANA	JudecatoriaSECTORUL1BUCURESTI
STANCU	MARIUS	JudecatoriaSECTORUL1BUCURESTI
TATU 	GABRIELA	JudecatoriaSECTORUL1BUCURESTI
TUDOSE	MIHAELA	JudecatoriaSECTORUL1BUCURESTI
TUDOR	GEORGIANA	JudecatoriaSECTORUL1BUCURESTI
ULMEANU	PETRUTA	JudecatoriaSECTORUL1BUCURESTI
VÎLCEANU	ANCA LAURA	JudecatoriaSECTORUL1BUCURESTI
VOICU 	ANAMARIA	JudecatoriaSECTORUL1BUCURESTI
VOINEAG	EUGENIA	JudecatoriaSECTORUL1BUCURESTI
ZAMFIR	ELENA	JudecatoriaSECTORUL1BUCURESTI
ARGHIR	BOGDAN ALEX	JudecatoriaSECTORUL2BUCURESTI
BARCĂU	ADRIANA DANIELA	JudecatoriaSECTORUL2BUCURESTI
BĂRĂSCU	MARIA VIRGINIA	JudecatoriaSECTORUL2BUCURESTI
BĂRBULESCU	RAMONA MARIA	JudecatoriaSECTORUL2BUCURESTI
BOERESCU	CIPRIAN	JudecatoriaSECTORUL2BUCURESTI
CAPOTĂ	CRINA CRISTINA	JudecatoriaSECTORUL2BUCURESTI
CESLEA	NICOLAE - ALEXANDRU	JudecatoriaSECTORUL2BUCURESTI
CHELCEA	CONSTANTIN	JudecatoriaSECTORUL2BUCURESTI
CIOCAN	RADU ANDREI	JudecatoriaSECTORUL2BUCURESTI
CIORGODA	TOMA-FLORIAN	JudecatoriaSECTORUL2BUCURESTI
COJOCARU	CRISTIAN-MIHAI	JudecatoriaSECTORUL2BUCURESTI
COMAN	GEORGIANA	JudecatoriaSECTORUL2BUCURESTI
CREŢESCU	ELENA	JudecatoriaSECTORUL2BUCURESTI
DAVID	DANIEL MARIUS	JudecatoriaSECTORUL2BUCURESTI
FLOREA	ECATERINA	JudecatoriaSECTORUL2BUCURESTI
GAVRILĂ	DIANA ELENA	JudecatoriaSECTORUL2BUCURESTI
GULUŢANU	ALINA NADIA	JudecatoriaSECTORUL2BUCURESTI
IURA 	ELENA VERONICA ANDREEA	JudecatoriaSECTORUL2BUCURESTI
IVAN	MIHAELA DORINA	JudecatoriaSECTORUL2BUCURESTI
IVĂNCIOIU	FLORENTINA	JudecatoriaSECTORUL2BUCURESTI
MACARIE	ADRIANA	JudecatoriaSECTORUL2BUCURESTI
MIHALI-VIORESCU	LUCIAN	JudecatoriaSECTORUL2BUCURESTI
MILITARU	EVDA SERENA	JudecatoriaSECTORUL2BUCURESTI
MÎNDRU	LUMINIŢA MIRELA	JudecatoriaSECTORUL2BUCURESTI
MOISE	MARIAN VIRGIL	JudecatoriaSECTORUL2BUCURESTI
NISTOR	FLORELA	JudecatoriaSECTORUL2BUCURESTI
OANCEA	ADRIAN CĂTĂLIN	JudecatoriaSECTORUL2BUCURESTI
PAVEL	MIRCEA-CATALIN	JudecatoriaSECTORUL2BUCURESTI
PELIN	OANA ELENA	JudecatoriaSECTORUL2BUCURESTI
PETRESCU	VALENTINA LILIANA	JudecatoriaSECTORUL2BUCURESTI
POPESCU	IOANA - ANDREEA	JudecatoriaSECTORUL2BUCURESTI
POPESCU	IRINA GABRIELA	JudecatoriaSECTORUL2BUCURESTI
POPESCU	MARIANA	JudecatoriaSECTORUL2BUCURESTI
PRISĂCARU 	MONA MARCELA	JudecatoriaSECTORUL2BUCURESTI
RIZESCU	FLORINA	JudecatoriaSECTORUL2BUCURESTI
SIGMUND	NICOLETA	JudecatoriaSECTORUL2BUCURESTI
SOARE 	NICOLETA	JudecatoriaSECTORUL2BUCURESTI
STOICA	ANCA-MARIA	JudecatoriaSECTORUL2BUCURESTI
STOICA	MONICA - MIRABELA	JudecatoriaSECTORUL2BUCURESTI
TARI	VLAD	JudecatoriaSECTORUL2BUCURESTI
VÂRŞESCU	CONSTANTA-MARIANA	JudecatoriaSECTORUL2BUCURESTI
VLASE	NADINA	JudecatoriaSECTORUL2BUCURESTI
ANDRIEŞ	DANIELA	JudecatoriaSECTORUL3BUCURESTI
ANGHELUTA	IOANA	JudecatoriaSECTORUL3BUCURESTI
AVRAMESCU	CLAUDIA-MONICA	JudecatoriaSECTORUL3BUCURESTI
BADIN	TANIA-LOREDANA	JudecatoriaSECTORUL3BUCURESTI
CHIRIAZI	LIVIA GEORGETA	JudecatoriaSECTORUL3BUCURESTI
CHIRITA	MARINA	JudecatoriaSECTORUL3BUCURESTI
CHIŢOIU	ADRIAN IOAN	JudecatoriaSECTORUL3BUCURESTI
CHIUJDEA	DENIS BRINDUSA	JudecatoriaSECTORUL3BUCURESTI
CLEJA	LAURA CAMELIA	JudecatoriaSECTORUL3BUCURESTI
COMAN	GEORGETA	JudecatoriaSECTORUL3BUCURESTI
COROBANĂ	CLAUDIU EDUARD	JudecatoriaSECTORUL3BUCURESTI
CRĂCIUN	ALEXANDRINA ELENA	JudecatoriaSECTORUL3BUCURESTI
CRACIUNESCU	CRISTIANA-MIHAELA	JudecatoriaSECTORUL3BUCURESTI
CRISTEA	LAURA	JudecatoriaSECTORUL3BUCURESTI
DÎRZEANU	IULIAN	JudecatoriaSECTORUL3BUCURESTI
DRĂGUŞANU	IOANA	JudecatoriaSECTORUL3BUCURESTI
DUNCA	GABI GABRIELA	JudecatoriaSECTORUL3BUCURESTI
ENE	MIRELA	JudecatoriaSECTORUL3BUCURESTI
FERENTZ	VIORELA IYABELA	JudecatoriaSECTORUL3BUCURESTI
GEANTĂ	MIHAI GEORGEL	JudecatoriaSECTORUL3BUCURESTI
ILIESCU	ELENA-BIANCA	JudecatoriaSECTORUL3BUCURESTI
IVASCIUC	ANA MARIA	JudecatoriaSECTORUL3BUCURESTI
LAZĂR	DENISA FLORINA	JudecatoriaSECTORUL3BUCURESTI
LAZĂR	IULIA ELENA	JudecatoriaSECTORUL3BUCURESTI
LEANCĂ	SILVIA	JudecatoriaSECTORUL3BUCURESTI
LIVĂDARIU	MARIA	JudecatoriaSECTORUL3BUCURESTI
LUPULESCU	GRIG-EMILIAN	JudecatoriaSECTORUL3BUCURESTI
MARIAN	DIANA MARIA	JudecatoriaSECTORUL3BUCURESTI
MECEANU	CONSTANTIN DANIEL	JudecatoriaSECTORUL3BUCURESTI
MEHEDINŢEANU	MIRELA	JudecatoriaSECTORUL3BUCURESTI
MIHAI	ELENA ROBERTINA	JudecatoriaSECTORUL3BUCURESTI
MIHAI	ANDREEA CECILIA	JudecatoriaSECTORUL3BUCURESTI
MITREA	ADINA	JudecatoriaSECTORUL3BUCURESTI
MUSCALU	MADALINA	JudecatoriaSECTORUL3BUCURESTI
PAŞCA CAMENIŢĂ	SANDRA IULIA	JudecatoriaSECTORUL3BUCURESTI
POP	ANDREEA - MARIA	JudecatoriaSECTORUL3BUCURESTI
STAMATE	DANIELA-ALEXANDRA	JudecatoriaSECTORUL3BUCURESTI
STĂNCIOI	DANIELA IOANA	JudecatoriaSECTORUL3BUCURESTI
STANOIU	ADINA-NICOLETA	JudecatoriaSECTORUL3BUCURESTI
STEFAN	FLORELA-CRISTINA	JudecatoriaSECTORUL3BUCURESTI
STOIAN	MIHAELA	JudecatoriaSECTORUL3BUCURESTI
SUCIU	RUXANDRA	JudecatoriaSECTORUL3BUCURESTI
TĂNASE	ANDREEA	JudecatoriaSECTORUL3BUCURESTI
TUDOSE	BADEA  MARIUS	JudecatoriaSECTORUL3BUCURESTI
ŢOCU	MARIA MAGDALENA	JudecatoriaSECTORUL3BUCURESTI
UMBRES	ALEXANDRU	JudecatoriaSECTORUL3BUCURESTI
VARZARU	MARIA - VIOLETA	JudecatoriaSECTORUL3BUCURESTI
VERCICAN	ANA MARIA	JudecatoriaSECTORUL3BUCURESTI
VOINEA	ANA - CORINA	JudecatoriaSECTORUL3BUCURESTI
VLADESCU	LILIANA -MARIETA	JudecatoriaSECTORUL3BUCURESTI
VORNICU	NICOLETA	JudecatoriaSECTORUL3BUCURESTI
ZAMFIR	CATALIN-DORU	JudecatoriaSECTORUL3BUCURESTI
VĂCARU (fostă BUDICĂ)	CLAUDIA IULIANA	JudecatoriaSECTORUL3BUCURESTI
ANDRIESCU	ROXANA	JudecatoriaSECTORUL4BUCURESTI
BERNEA	MIHAI	JudecatoriaSECTORUL4BUCURESTI
CHIRITA - SANDU	NICOLETA-MONICA	JudecatoriaSECTORUL4BUCURESTI
COLŢUNEAC	CONSTANTINA 	JudecatoriaSECTORUL4BUCURESTI
CONSTANTINESCU	MINOLA	JudecatoriaSECTORUL4BUCURESTI
COZMA	MIHAI-PAUL	JudecatoriaSECTORUL4BUCURESTI
CRISTEA	CRISTINA MARIA	JudecatoriaSECTORUL4BUCURESTI
DAHORE	EUGENIA	JudecatoriaSECTORUL4BUCURESTI
DINESCU	ADRIAN GABRIEL	JudecatoriaSECTORUL4BUCURESTI
DRĂGUŞIN	CLAUDIU MARIAN	JudecatoriaSECTORUL4BUCURESTI
DUMITRESCU	RALUCA ADRIANA	JudecatoriaSECTORUL4BUCURESTI
FAGET	VERONICA	JudecatoriaSECTORUL4BUCURESTI
FELDIOREANU	MARIANA	JudecatoriaSECTORUL4BUCURESTI
GIURCHITA	DUMITRU-SILVIU	JudecatoriaSECTORUL4BUCURESTI
IONESCU	ANDREEA	JudecatoriaSECTORUL4BUCURESTI
LASCU	GABRIELA	JudecatoriaSECTORUL4BUCURESTI
MAZILU	GABRIELA CRISTINA	JudecatoriaSECTORUL4BUCURESTI
MĂNESCU	MARIA RAMONA	JudecatoriaSECTORUL4BUCURESTI
MIHALCEA	MIHAI ALEXANDRU	JudecatoriaSECTORUL4BUCURESTI
MIHĂIŢĂ 	FLORIN	JudecatoriaSECTORUL4BUCURESTI
MOTEANU	IOANA-LUIZA	JudecatoriaSECTORUL4BUCURESTI
MOTOI	CONSTANTIN DANIEL	JudecatoriaSECTORUL4BUCURESTI
PANTAZI	FLORICA DANIELA	JudecatoriaSECTORUL4BUCURESTI
PĂTRAŞCU	MARIUS	JudecatoriaSECTORUL4BUCURESTI
POPA	CORNELIA	JudecatoriaSECTORUL4BUCURESTI
POPA-MOCANU	IULIU-OTONEL	JudecatoriaSECTORUL4BUCURESTI
POPESCU	CLARA MARIA	JudecatoriaSECTORUL4BUCURESTI
POPESCU	LUCIAN -DUMITRU	JudecatoriaSECTORUL4BUCURESTI
POTCOAVĂ	FLORIN MIHAI	JudecatoriaSECTORUL4BUCURESTI
PUTINTEI	MIHAELA-OANA	JudecatoriaSECTORUL4BUCURESTI
RĂILEANU	TOMA CĂTĂLIN	JudecatoriaSECTORUL4BUCURESTI
ROMAN	ADRIAN	JudecatoriaSECTORUL4BUCURESTI
SÎRBU	VERONICA	JudecatoriaSECTORUL4BUCURESTI
TRĂISTARU	ALEXANDRA	JudecatoriaSECTORUL4BUCURESTI
VÎLCEANU	FLORIN	JudecatoriaSECTORUL4BUCURESTI
AGACHI	DANIEL CIPRIAN	JudecatoriaSECTORUL5BUCURESTI
ANDREI	MIHAELA-CAMELIA	JudecatoriaSECTORUL5BUCURESTI
APOSTOLICEANU	ECATERINA -CARMEN	JudecatoriaSECTORUL5BUCURESTI
BIDIUTA	OANA-GEORGIANA	JudecatoriaSECTORUL5BUCURESTI
CÎRSTEA	ADELA	JudecatoriaSECTORUL5BUCURESTI
CORCOVEANU	IULIANA-RODICA	JudecatoriaSECTORUL5BUCURESTI
COZMA	MIHAELA-ROXANA	JudecatoriaSECTORUL5BUCURESTI
DRAGOMIR	MARIAN IONUŢ	JudecatoriaSECTORUL5BUCURESTI
DUMITRESCU	CRISTINA-SORANA	JudecatoriaSECTORUL5BUCURESTI
FINTA	FABIOLA CORINA	JudecatoriaSECTORUL5BUCURESTI
FLEŞER	ADINA MARIANA	JudecatoriaSECTORUL5BUCURESTI
GHICA	ELENA-MIRUNA	JudecatoriaSECTORUL5BUCURESTI
GRIGORE	DELIA CRISTINA	JudecatoriaSECTORUL5BUCURESTI
GROSU	DANA IONELA	JudecatoriaSECTORUL5BUCURESTI
ILINA	SERGIU - IONUT	JudecatoriaSECTORUL5BUCURESTI
IUGAN	ANDREI VIOREL	JudecatoriaSECTORUL5BUCURESTI
LIMONA	CLAUDIU- ALESSANDRO	JudecatoriaSECTORUL5BUCURESTI
MIHALAŞCU	ANTOANETA MĂDĂLINA	JudecatoriaSECTORUL5BUCURESTI
MOISE	CRISTINA LAURA	JudecatoriaSECTORUL5BUCURESTI
MURGOCI LUCA	AURELIAN MARIAN	JudecatoriaSECTORUL5BUCURESTI
NICULESCU	IONUT - ALEXANDRU	JudecatoriaSECTORUL5BUCURESTI
PANĂ	ALEXANDRA RALUCA	JudecatoriaSECTORUL5BUCURESTI
PANDELESCU	MARIELA CORNELIA	JudecatoriaSECTORUL5BUCURESTI
PĂSTOREANU	ANA MIRELA	JudecatoriaSECTORUL5BUCURESTI
PLEŞANU	OLIVIA DARIANA	JudecatoriaSECTORUL5BUCURESTI
PUIU	ANA MARIA	JudecatoriaSECTORUL5BUCURESTI
RADU	ELENA	JudecatoriaSECTORUL5BUCURESTI
ROSEANU	OANA - STELA	JudecatoriaSECTORUL5BUCURESTI
SLUJITORU	IULIA	JudecatoriaSECTORUL5BUCURESTI
SORESCU	ELENA-VALENTINA	JudecatoriaSECTORUL5BUCURESTI
STĂTESCU	ALEXANDRU-MARIAN	JudecatoriaSECTORUL5BUCURESTI
STOICA	DANIELA DELIA	JudecatoriaSECTORUL5BUCURESTI
TĂNASE	MIHNEA ADRIAN	JudecatoriaSECTORUL5BUCURESTI
TODOSI	DIANA GABRIELA	JudecatoriaSECTORUL5BUCURESTI
TRAILA	VICTORIA-ALINA	JudecatoriaSECTORUL5BUCURESTI
URSAN	IULIA	JudecatoriaSECTORUL5BUCURESTI
ANDREI	GEORGETA	JudecatoriaSECTORUL6BUCURESTI
AXINTI	NICOLETA	JudecatoriaSECTORUL6BUCURESTI
BELDIANU	DIANA -CRISTINA	JudecatoriaSECTORUL6BUCURESTI
BÂREA BREZAIE	ALEXANDRA LUIZA	JudecatoriaSECTORUL6BUCURESTI
BOGDAN	IOANA	JudecatoriaSECTORUL6BUCURESTI
BOLLA	SABINA IOANA	JudecatoriaSECTORUL6BUCURESTI
BOROI	DANA	JudecatoriaSECTORUL6BUCURESTI
BOURCEANU	VIVIANA	JudecatoriaSECTORUL6BUCURESTI
CARP	DIMITRIE GHEORGHE	JudecatoriaSECTORUL6BUCURESTI
COJOCARU	ADINA-ELENA	JudecatoriaSECTORUL6BUCURESTI
CONSTANTINESCU	VICTOR HORIA DIMITRIE	JudecatoriaSECTORUL6BUCURESTI
COSTACHE IVANOV	CRISTINA	JudecatoriaSECTORUL6BUCURESTI
CUCU	ALEXANDRINA MARIANA	JudecatoriaSECTORUL6BUCURESTI
DATCU	FLORINA ALEXANDRA	JudecatoriaSECTORUL6BUCURESTI
DIACONU	DELIA CRISTINA	JudecatoriaSECTORUL6BUCURESTI
DINU	BOGDAN JUSTIN	JudecatoriaSECTORUL6BUCURESTI
DOCHITA	MIHAELA	JudecatoriaSECTORUL6BUCURESTI
EZER	LAVINIA	JudecatoriaSECTORUL6BUCURESTI
GAVRILĂ	BOGDAN	JudecatoriaSECTORUL6BUCURESTI
GRIGORE	ADRIANA	JudecatoriaSECTORUL6BUCURESTI
GROZAV	OCTAVIAN IONEL	JudecatoriaSECTORUL6BUCURESTI
MAGA	SIMONA-SILVIA	JudecatoriaSECTORUL6BUCURESTI
MĂRICUŢOIU	FLAVIA CRISTINA	JudecatoriaSECTORUL6BUCURESTI
MUNTEANU	VERONICA	JudecatoriaSECTORUL6BUCURESTI
MUNTEANU	IONELA DANIELA	JudecatoriaSECTORUL6BUCURESTI
OPREA	ELENA-ALINA	JudecatoriaSECTORUL6BUCURESTI
POSTELNICU	LUCRETIA-ALBERTINA	JudecatoriaSECTORUL6BUCURESTI
RĂUŢ	ALEXANDRA-SIMONA	JudecatoriaSECTORUL6BUCURESTI
SÎRGHI	RUXANDRA	JudecatoriaSECTORUL6BUCURESTI
STEFAN	CLAUDIA-CONSTANTINA	JudecatoriaSECTORUL6BUCURESTI
TOMA	IOANA LAURA	JudecatoriaSECTORUL6BUCURESTI
TUDOR	ANDREEA CRISTINA	JudecatoriaSECTORUL6BUCURESTI
VOICU	SANDINA 	JudecatoriaSECTORUL6BUCURESTI
AIONESE	NADIA	TribunalulILFOV
ANDRAŞ	MIHAELA RALUCA	TribunalulILFOV
ANTONESCU	LOREDANA GEANINA	TribunalulILFOV
CARCIA	LAURA CRISTINA	TribunalulILFOV
CIORNEI	MANUELA ALMA	TribunalulILFOV
DOBRESCU	CRISTINA	TribunalulILFOV
DUMITRESCU	ALINA	TribunalulILFOV
EPURAN	MIRCEA	TribunalulILFOV
GRECU	CRISTINA	TribunalulILFOV
IVAN	STELA FLORENTINA	TribunalulILFOV
MIHAI	CĂTĂLIN CONSTANTIN	TribunalulILFOV
NĂSTASIE 	NICOLETA MIRELA	TribunalulILFOV
NEDELEA	ROXANA	TribunalulILFOV
NEGRESCU	GHEORGHE	TribunalulILFOV
OPRINA 	EVELINA MIRELA	TribunalulILFOV
PĂŞTILĂ 	RĂZVAN	TribunalulILFOV
PETCU	ROXANA IOANA	TribunalulILFOV
ROMAN	MIHAI RADU	TribunalulILFOV
BURCEA 	ANDREEA LAURA	JudecatoriaBUFTEA
COJOCARU	ADRIAN	JudecatoriaBUFTEA
DUMBRAVĂ	EDGAR LAURENŢIU	JudecatoriaBUFTEA
ENE	MARIANA	JudecatoriaBUFTEA
FLORESCU	ALINA LOREDANA	JudecatoriaBUFTEA
GĂLĂŢANU	NICOLETA	JudecatoriaBUFTEA
GHIHANIŞ	ALINA	JudecatoriaBUFTEA
ILIE 	CRISTIAN RĂZVAN	JudecatoriaBUFTEA
IORDĂCHESCU	ELISABETA	JudecatoriaBUFTEA
LAYET	CARMEN	JudecatoriaBUFTEA
MARTIN	ANDREIA NICOLETA	JudecatoriaBUFTEA
RADU	VLAD ALEXANDRU	JudecatoriaBUFTEA
STEREA	AURICA	JudecatoriaBUFTEA
TĂŞCAN	ADRIANA	JudecatoriaBUFTEA
VIŞAN	ALIN VALENTIN	JudecatoriaBUFTEA
BOGEA	MIHAELA	JudecatoriaCORNETU
BUDEI	CLAUDIA OANA	JudecatoriaCORNETU
CĂLIN	ADRIAN - CRISTIAN	JudecatoriaCORNETU
CĂLIN	DELIA	JudecatoriaCORNETU
CONSTANTINESCU	NICOLETA GEORGETA	JudecatoriaCORNETU
DAMASCHIN	ENIKO	JudecatoriaCORNETU
DASCĂLU	LIVIŞOR	JudecatoriaCORNETU
DAVIDOIU	MONICA ELENA	JudecatoriaCORNETU
DELCEA	SERGIU	JudecatoriaCORNETU
DINIŢĂ	CAMELIA	JudecatoriaCORNETU
DURDEA	LUCIAN	JudecatoriaCORNETU
FILIPESCU	ANCA – LAVINIA	JudecatoriaCORNETU
GOCIU	MARIAN	JudecatoriaCORNETU
MAGDALENA 	NICOLAE CĂTĂLIN	JudecatoriaCORNETU
MARIN	VASILE BOGDAN	JudecatoriaCORNETU
STOIAN 	IRINA	JudecatoriaCORNETU
ALECXANDRU	PETRONEL IULIAN	TribunalulCALARASI
CHIRU	GHEORGHE	TribunalulCALARASI
COCORANU	MIHAELA -AURELIA	TribunalulCALARASI
CONSTANTIN	NICOLETA -PETRONELA	TribunalulCALARASI
COSTACHE	NICOLAE - CONSTANTIN	TribunalulCALARASI
DUMITRU	NICOLETA	TribunalulCALARASI
ENACHE	TRAIAN	TribunalulCALARASI
GHITA	CRISTIANA -MIOARA	TribunalulCALARASI
HODEL	AURICA	TribunalulCALARASI
ILEANA	LILIANA	TribunalulCALARASI
IORDACHE	CORNELIA	TribunalulCALARASI
POPA	MIRCEA -VIOREL	TribunalulCALARASI
RADU	RODICA	TribunalulCALARASI
STOIAN 	GHEORGHE	TribunalulCALARASI
STOIAN 	SEVASTIŢA	TribunalulCALARASI
ŞERBAN	GEORGE CĂTĂLIN	TribunalulCALARASI
TANASE	GABRIELA	TribunalulCALARASI
TUDORACHE	NELUTA- MARINICA	TribunalulCALARASI
ACHIM	NELA -OLIMPIA	JudecatoriaCALARASI
ALECXANDRU	ILEANA	JudecatoriaCALARASI
CĂLIN	SILVIANA CAMELIA	JudecatoriaCALARASI
DINCA	IONEL	JudecatoriaCALARASI
ENESCU	ELENA- DANA	JudecatoriaCALARASI
IONESCU	OANA	JudecatoriaCALARASI
NECULA	RADU MIHAI	JudecatoriaCALARASI
NEDELCU	LIVIU PETRONEL	JudecatoriaCALARASI
OPRIŞAN	VICA	JudecatoriaCALARASI
STANCIU	MARIANA	JudecatoriaCALARASI
TOADER	CARMEN ANDREEA	JudecatoriaCALARASI
ALEXANDRU	IONEL	JudecatoriaOLTENITA
BODIRLAU	AURICA	JudecatoriaOLTENITA
CAZACU	VIOREL	JudecatoriaOLTENITA
DELOREANU	LAURENŢIU	JudecatoriaOLTENITA
GRECU	CIPRIAN OCTAVIAN	JudecatoriaOLTENITA
MARDARE	ANGELA	JudecatoriaOLTENITA
MIHAI	ELENA	JudecatoriaOLTENITA
ŢENESCU	MARIOARA	JudecatoriaOLTENITA
GRIGORE	CRISTINA - ELENA	JudecatoriaLEHLIUGARA
IONIŢĂ	ALINA DOINA	JudecatoriaLEHLIUGARA
JOGA	MIHAELA -DANIELA	JudecatoriaLEHLIUGARA
MACOVEI	ADINA EUGENIA	JudecatoriaLEHLIUGARA
STOICA	ANCUŢA MARIA	JudecatoriaLEHLIUGARA
AYDIN	LUCIANA	TribunalulGIURGIU
BURTAVEL	MARIANA MAGDALENA	TribunalulGIURGIU
CERCEL-MARES	ION	TribunalulGIURGIU
CODREANU	PETRONELA	TribunalulGIURGIU
CORNEA	MONICA	TribunalulGIURGIU
DEFTA	SPERANTA ELENA	TribunalulGIURGIU
GHITA	OITA	TribunalulGIURGIU
ISTRĂTESCU	ACHIM	TribunalulGIURGIU
NETEJORU	LUCIAN	TribunalulGIURGIU
NICULA	ION	TribunalulGIURGIU
PINCIU	CRISTINA	TribunalulGIURGIU
POPESCU	GHERGHIŢA	TribunalulGIURGIU
RĂDUCU	FLORENTINA	TribunalulGIURGIU
RĂDUINEA BENONE	ALIN	TribunalulGIURGIU
TUDORACHE	GHEORGHE	TribunalulGIURGIU
UDREA	MIRELA ZINA	TribunalulGIURGIU
URECHE	GRIGORE	TribunalulGIURGIU
BĂRĂILĂ	ROXANA CRISTINA	JudecatoriaGIURGIU
CONSTANTINOF	MARIA ADELINA	JudecatoriaGIURGIU
CRĂIŢOIU	GENICA	JudecatoriaGIURGIU
DATCU	CAMELIA	JudecatoriaGIURGIU
DĂIANU	ION	JudecatoriaGIURGIU
DRĂGUŢ	MARIUS	JudecatoriaGIURGIU
DUMITRU	CRISTIAN	JudecatoriaGIURGIU
GOGAN	ADRIAN	JudecatoriaGIURGIU
IVANCIUC	SORIN VASILE	JudecatoriaGIURGIU
MĂCSINOIU 	ALEXANDRU	JudecatoriaGIURGIU
MIRLOGEANU	MARIANA	JudecatoriaGIURGIU
MODORAN	LAURENŢIU FLORIN	JudecatoriaGIURGIU
NEGHINĂ	IONEL FLORIN	JudecatoriaGIURGIU
NICULA	NICOLETA RAMONA	JudecatoriaGIURGIU
NICULESCU	DOINA MARIA	JudecatoriaGIURGIU
ORZAŢĂ 	MARIA MANUELA	JudecatoriaGIURGIU
PENCEA 	ADRIANA	JudecatoriaGIURGIU
POMENEA	MARIN	JudecatoriaGIURGIU
SAVU	ANA	JudecatoriaGIURGIU
ŞTEFĂNESCU 	ANCA ELENA	JudecatoriaGIURGIU
BUGNAR	CRISTINA	JudecatoriaBOLINTINVALE
BURULEANU	ALEXANDRA ELENA	JudecatoriaBOLINTINVALE
COMAN	CLAUDIA	JudecatoriaBOLINTINVALE
DRAICA	LAURA MARIA	JudecatoriaBOLINTINVALE
LUCA	ROZALIA CRISTINA	JudecatoriaBOLINTINVALE
LUPAŞCU	LUCICA	JudecatoriaBOLINTINVALE
PULBERE	VIOLETA ANDREEA	JudecatoriaBOLINTINVALE
TACHE	IOANA	JudecatoriaBOLINTINVALE
BERCARU	ALEXANDRU	TribunalulIALOMITA
BURLACU	MARIANA	TribunalulIALOMITA
CIUREA	GEORGEL	TribunalulIALOMITA
DICULESCU	ION	TribunalulIALOMITA
DUTA	CAMELIA TATIANA	TribunalulIALOMITA
IANCU	MIOARA	TribunalulIALOMITA
IONESCU	TRAIAN	TribunalulIALOMITA
IVĂNICĂ	MARIANA RALUCA	TribunalulIALOMITA
MARCU	ALIS GABRIELA	TribunalulIALOMITA
MUNTEANU	LARISA ISABELLA	TribunalulIALOMITA
MUSAT	MIHAELA - SIMONA	TribunalulIALOMITA
MUSAT	TANCUTA	TribunalulIALOMITA
MUŞAT	VIORICA	TribunalulIALOMITA
OLTEANU	TUDOR	TribunalulIALOMITA
RĂCEANU	DANIELA	TribunalulIALOMITA
TOMA	ION	TribunalulIALOMITA
TUDOR	IONELA	TribunalulIALOMITA
VASILE	DANIELA	TribunalulIALOMITA
ZANFIR	INGRID - GILDA	TribunalulIALOMITA
ANDREI	ADRIANA	JudecatoriaSLOBOZIA
DUŢĂ	MIRELA ANDREEA	JudecatoriaSLOBOZIA
JOIŢA	MARIUS IULIAN	JudecatoriaSLOBOZIA
LEANCA	COSMIN	JudecatoriaSLOBOZIA
PISMIS	VIORICA	JudecatoriaSLOBOZIA
PĂDURARU	GEORGE CRISTIAN	JudecatoriaSLOBOZIA
STAMATE	OCTAVIAN	JudecatoriaSLOBOZIA
STAMATOIU	PETRONELA	JudecatoriaSLOBOZIA
ŞERBAN	NICOLAE	JudecatoriaSLOBOZIA
VERNEA	SORIN ALEXANDRU	JudecatoriaSLOBOZIA
COMAN	ELENA - MINERVA	JudecatoriaURZICENI
DIACONU	ALEXANDRA ELENA	JudecatoriaURZICENI
DOGARU	LIVIU MARIAN	JudecatoriaURZICENI
DUMITRACHE	ELENA	JudecatoriaURZICENI
MIHALACHE	SILVIA MONICA	JudecatoriaURZICENI
NETCU	GINA-FLORENTINA	JudecatoriaURZICENI
OJOG	ELENA	JudecatoriaURZICENI
TĂNASE 	DANIELA NICOLETA	JudecatoriaURZICENI
ANTON	CARLA DANIELA	JudecatoriaFETESTI
BEŞU	IONEL LAURENŢIU	JudecatoriaFETESTI
IANCU	GABRIELA CORINA	JudecatoriaFETESTI
MATEESCU	MARIA VALENTINA	JudecatoriaFETESTI
POPESCU	IULIA	JudecatoriaFETESTI
REGHINA	ION	JudecatoriaFETESTI
ARSENIE	LIANA NICOLETA	TribunalulTELEORMAN
CERNAT	DOINITA	TribunalulTELEORMAN
DOBRIN	MARIANA NUŢI	TribunalulTELEORMAN
DRAGHICI	LUMINITA- VERGINIA -MIOARA	TribunalulTELEORMAN
ENESCU	EMILIA -ELENA	TribunalulTELEORMAN
FIFOIU	MARINELA	TribunalulTELEORMAN
GUDAC	PETRICA	TribunalulTELEORMAN
IATAN	MARIUS COSTINEL	TribunalulTELEORMAN
MAIDANUC	VIOLETA	TribunalulTELEORMAN
MORTU	MARIN	TribunalulTELEORMAN
NITULESCU	MARIA	TribunalulTELEORMAN
RĂDUCU	MIRELA	TribunalulTELEORMAN
ROTARU	VIORICA -GABRIELA	TribunalulTELEORMAN
SÎRBU	LELIA	TribunalulTELEORMAN
TEODORESCU	ION	TribunalulTELEORMAN
TRĂISTARU	NICOLAE	TribunalulTELEORMAN
TRIFAN	IRENA	TribunalulTELEORMAN
VĂDUVA	VICTORIA	TribunalulTELEORMAN
VIRDOL	MIHAELA NARCISA	TribunalulTELEORMAN
ZAMFIR	LENUTA	TribunalulTELEORMAN
BOZEŞAN	VASILE	JudecatoriaALEXANDRIA
DINCĂ	ANDREI RADU	JudecatoriaALEXANDRIA
DUŢĂ	MIHAI GABRIEL	JudecatoriaALEXANDRIA
MIHALAŞCU	IONUŢ - MARIUS	JudecatoriaALEXANDRIA
PASCA	FLOREA	JudecatoriaALEXANDRIA
PÎRJOL	COSMIN GABRIEL	JudecatoriaALEXANDRIA
PODEA	ELENA SIMONA	JudecatoriaALEXANDRIA
POPESCU	DANA ALINA	JudecatoriaALEXANDRIA
DINU	NICOLETA FELICIA	JudecatoriaROSIORIDEVEDE
IFRIM	DANIELA VALENTINA	JudecatoriaROSIORIDEVEDE
ILIESCU	PETRA	JudecatoriaROSIORIDEVEDE
LINCA	FLORIN DANUT	JudecatoriaROSIORIDEVEDE
MAXIMILIAN	CORNELIA-LUMINITA	JudecatoriaROSIORIDEVEDE
MITROI	COSMIN - RADU	JudecatoriaROSIORIDEVEDE
NANU	MARGA	JudecatoriaROSIORIDEVEDE
PĂUNA	MARIA-MAGDALENA	JudecatoriaROSIORIDEVEDE
CIOCOIU	ANISOARA	JudecatoriaTURNUMAGURELE
DIACONU	LINA	JudecatoriaTURNUMAGURELE
DINCĂ	RUXANDRA	JudecatoriaTURNUMAGURELE
FLOREA	MIRELA CAMELIA	JudecatoriaTURNUMAGURELE
IACOB	VICTORINA	JudecatoriaTURNUMAGURELE
NEAGU	FLOAREA	JudecatoriaTURNUMAGURELE
VOINEA	ION	JudecatoriaTURNUMAGURELE
ZIDARU	LORENA MIHAELA	JudecatoriaTURNUMAGURELE
ILIE	EUGENIA RAMONA	JudecatoriaVIDELE
OPRIŞĂNESCU	SIMONA	JudecatoriaVIDELE
BUCU	ANA	JudecatoriaZIMNICEA
NEAMU	CAMELIA ROZALIA	JudecatoriaZIMNICEA
OLARU	DAN	JudecatoriaZIMNICEA
OLTEANU	ELENA CORNELIA	JudecatoriaZIMNICEA
SACERDOŢEANU	CORINA ELENA	JudecatoriaZIMNICEA
ALBU	EMANUEL	Înalta Curte de Casație și Justiție
ARGHIR	GEANINA CRISTINA	Înalta Curte de Casație și Justiție
ARON	MIRCEA BUCUREL	Înalta Curte de Casație și Justiție
BARBĂ 	IONEL	Înalta Curte de Casație și Justiție
BARBĂLATĂ 	GEORGETA	Înalta Curte de Casație și Justiție
BÎRSAN	GABRIELA VICTORIA	Înalta Curte de Casație și Justiție
BOGASIU	GABRIELA	Înalta Curte de Casație și Justiție
BOGDAN	IOANA	Înalta Curte de Casație și Justiție
BORDEA	ADRIAN	Înalta Curte de Casație și Justiție
BRÂNZAN 	CONSTANTIN	Înalta Curte de Casație și Justiție
BREHAR	PAULINA LUCIA	Înalta Curte de Casație și Justiție
BUDĂ	MARIAN	Înalta Curte de Casație și Justiție
CANŢĂR	ELENA	Înalta Curte de Casație și Justiție
CERBU	SILVIA	Înalta Curte de Casație și Justiție
CÎRSTOCEA	MARIANA	Înalta Curte de Casație și Justiție
CHIOSEAUA	ADRIANA	Înalta Curte de Casație și Justiție
CÂRCEI	ELENA	Înalta Curte de Casație și Justiție
CÎRNU 	IULIA MANUELA	Înalta Curte de Casație și Justiție
COBZARIU	MARICELA	Înalta Curte de Casație și Justiție
CONDOIU	MINODORA	Înalta Curte de Casație și Justiție
CONSTANDA	ANDREIA LIANA	Înalta Curte de Casație și Justiție
CORBU	CORINA ALINA	Înalta Curte de Casație și Justiție
CORNOIU	DĂNUŢ	Înalta Curte de Casație și Justiție
COSMA	RODICA	Înalta Curte de Casație și Justiție
COSMA	VIORICA	Înalta Curte de Casație și Justiție
CRISTESCU 	SIMONA LALA	Înalta Curte de Casație și Justiție
CURELEA	LAVINIA	Înalta Curte de Casație și Justiție
DASCĂLU	ANA	Înalta Curte de Casație și Justiție
DASCĂLU	LAVINIA	Înalta Curte de Casație și Justiție
DĂNĂILĂ	VERONICA MAGDALENA	Înalta Curte de Casație și Justiție
DOLACHE	ILEANA IZABELA	Înalta Curte de Casație și Justiție
DORIN	RODICA	Înalta Curte de Casație și Justiție
DRAGNE	ANGELA	Înalta Curte de Casație și Justiție
DRAGOMIR	FLORENTINA	Înalta Curte de Casație și Justiție
DRAGOMIR	ILIE IULIAN	Înalta Curte de Casație și Justiție
DRAGU	CREŢU	Înalta Curte de Casație și Justiție
DRĂGUŢ	FLORENTIN SORIN	Înalta Curte de Casație și Justiție
DUICAN	DOINA	Înalta Curte de Casație și Justiție
DUMITRAŞCU	SOFICA	Înalta Curte de Casație și Justiție
DUŢĂ	RUXANDRA - MONICA	Înalta Curte de Casație și Justiție
ENCEAN	SIMONA - DANIELA	Înalta Curte de Casație și Justiție
FLOAREA 	ELENA	Înalta Curte de Casație și Justiție
FOITOŞ	MARIUS DAN	Înalta Curte de Casație și Justiție
FRUMUŞELU	MAGDALENA - CARMEN	Înalta Curte de Casație și Justiție
GHENA	MARIANA	Înalta Curte de Casație și Justiție
GRIGORAŞ 	NINA ECATERINA	Înalta Curte de Casație și Justiție
HÎNCU	CEZAR	Înalta Curte de Casație și Justiție
IANCU	VIORICA	Înalta Curte de Casație și Justiție
IANOŞI 	CARMEN MINODORA	Înalta Curte de Casație și Justiție
ILIE	CARMEN MARIA	Înalta Curte de Casație și Justiție
ILIE 	IOANA ALINA	Înalta Curte de Casație și Justiție
ION	EUGENIA	Înalta Curte de Casație și Justiție
IORDACHE	MAGDALENA	Înalta Curte de Casație și Justiție
ISAILĂ	MĂRIOARA	Înalta Curte de Casație și Justiție
IVANOVICI	LAURA - MIHAELA	Înalta Curte de Casație și Justiție
JÎJÎIE 	CORINA MICHAELA	Înalta Curte de Casație și Justiție
LEFTERACHE	LAVINIA VALERIA	Înalta Curte de Casație și Justiție
LUŢAC	GHEORGHIŢA	Înalta Curte de Casație și Justiție
LUZESCU	CRISTINA	Înalta Curte de Casație și Justiție
MACAVEI	SĂNDEL LUCIAN	Înalta Curte de Casație și Justiție
MACAVEI	SORINELA ALINA	Înalta Curte de Casație și Justiție
MĂNIGUŢIU	NICULAE	Înalta Curte de Casație și Justiție
MARCU	SIMONA-CAMELIA	Înalta Curte de Casație și Justiție
MARIN	EUGENIA	Înalta Curte de Casație și Justiție
MATEI 	IONUŢ  MIHAI	Înalta Curte de Casație și Justiție
MERA	LUCIANA	Înalta Curte de Casație și Justiție
MIHĂIANU	COSMIN - HORIA	Înalta Curte de Casație și Justiție
MILĂŞAN	ZOIŢA	Înalta Curte de Casație și Justiție
MOGLAN	RALUCA	Înalta Curte de Casație și Justiție
MOTEA	AURELIA	Înalta Curte de Casație și Justiție
NĂSTASE	TATIANA GABRIELA	Înalta Curte de Casație și Justiție
NEGRILĂ	GEORGETA CARMEN	Înalta Curte de Casație și Justiție
NENIŢĂ	SIMONA CRISTINA	Înalta Curte de Casație și Justiție
NESTOR	BEATRICE - IOANA	Înalta Curte de Casație și Justiție
NICOLAE	ADINA GEORGETA	Înalta Curte de Casație și Justiție
PANTEA	PAULA	Înalta Curte de Casație și Justiție
PARASCHIV	MIHAELA	Înalta Curte de Casație și Justiție
PĂUN	LUIZA MARIA	Înalta Curte de Casație și Justiție
PETRIŞOR	NELA	Înalta Curte de Casație și Justiție
PIETREANU 	SIMONA - GINA	Înalta Curte de Casație și Justiție
PISTOL	ŞTEFAN	Înalta Curte de Casație și Justiție
POLIŢEANU	MIRELA	Înalta Curte de Casație și Justiție
POPA	RODICA AIDA	Înalta Curte de Casație și Justiție
POPA 	ROXANA	Înalta Curte de Casație și Justiție
POPESCU	DOINA	Înalta Curte de Casație și Justiție
POPESCU	MIRELA SORINA	Înalta Curte de Casație și Justiție
POPOIAG	ELENA CARMEN	Înalta Curte de Casație și Justiție
PUŞCAŞIU	EUGENIA	Înalta Curte de Casație și Justiție
RÎCIU	IULIANA	Înalta Curte de Casație și Justiție
ROG	LUCIA TATIANA	Înalta Curte de Casație și Justiție
ROTARU	CRISTINA	Înalta Curte de Casație și Justiție
RUSU	AURELIA	Înalta Curte de Casație și Justiție
SÎRBU	CARMEN	Înalta Curte de Casație și Justiție
SPINEANU MATEI	OCTAVIA	Înalta Curte de Casație și Justiție
STANCIU	LIVIA DOINA	Înalta Curte de Casație și Justiție
STĂNIŞOR	DENISA - ANGELICA	Înalta Curte de Casație și Justiție
SUSANU	RODICA	Înalta Curte de Casație și Justiție
ŞELARU	VALENTIN - HORIA	Înalta Curte de Casație și Justiție
ŞERBAN	LEONTINA	Înalta Curte de Casație și Justiție
TĂBÂRCĂ	MIHAELA	Înalta Curte de Casație și Justiție
TARCEA	IULIA CRISTINA	Înalta Curte de Casație și Justiție
TEAU 	TRĂNICA CARMEN	Înalta Curte de Casație și Justiție
TRESTIANU	VIORICA	Înalta Curte de Casație și Justiție
ŢĂNDĂRESCU	BIANCA ELENA	Înalta Curte de Casație și Justiție
ŢUCĂ	ALINA IULIANA	Înalta Curte de Casație și Justiție
VARTIRES	DANA IARINA	Înalta Curte de Casație și Justiție
VASILE 	FRANCISCA MARIA	Înalta Curte de Casație și Justiție
VĂLEANU	PETRONELA CRISTINA	Înalta Curte de Casație și Justiție
VIŞAN 	LILIANA	Înalta Curte de Casație și Justiție
VIŞAN 	MIRELA	Înalta Curte de Casație și Justiție
VOICHECI	EUGENIA	Înalta Curte de Casație și Justiție
VOICU	RODICA FLORICA	Înalta Curte de Casație și Justiție
VRÎNCEANU 	ROMANIŢA ECATERINA	Înalta Curte de Casație și Justiție
ZAHARIA	RODICA	Înalta Curte de Casație și Justiție
ZGLIMBEA	LUMINIŢA - LIVIA	Înalta Curte de Casație și Justiție